aĉ	pejorative
ad	duration
aĵ	concretisation
an	member
ar	group
ĉj	gentle_male
ebl	possibility
ec	abstract
eg	augmentative
ej	location
end	obligation
er	unit
estr	leader
et	small
id	child
ig	make
iĝ	become
il	tool
in	female
ind	merit
ing	partial_container
ism	doctrin
ist	profession
nj	gentle_female
obl	multiplicative
on	fraction
op	collective
uj	full_container
ul	specificity
um	none
