aardvark: terporko, orikteropo

abhor: abomeni

able: kapabla, lerta,

(to be) able: povi

abnegation: memforgeso

about (around): ĉirkaŭ

about (concerning): pri

above: super, supre

absent-minded: distrita

absolute: absoluta

absolve: absolvi, malkondamni

anstracted: distrita

absurd: malracia, absurda

ace! (AU): bonege!

accelerate: plirapid(iĝ/ig)i, akceli

accept:akcepti

accident: akcidento

accompany: akompani, kuniri?

accomplice: kunkulpulo

according to, along: laŭ

accountant: kalkulisto

accuse (of): akuzi (pri)

acne: akno, aknaro

acorn: glano, kverkonukso

acquaintance: konat(in)o

acquire: akiri

acrobat: akrobato

acronym: akronimo

across: trans

act: ago, agi, (on stage) aktori

activity: agado

actor: aktoro, (commedy) komediisto

actual: efektiva

actually: efektive

addax: adakso

adder: kolubro

address: adreso, adresi

address book: adreslibro, adresaro

admire: admiri

admit: konfesi

adore: adori

adorn: arnami

adult: plenkreska,  -ulo

advantage: avantaĝo

adventure: aventuro

adversary: kontraŭulo

advertise (announce): anonci

advertise: reklami

advertisement (announcement): anonco

advertisement: reklamo

advertising stunt: reklamfrapo

advice: konsilo

advise: konsili
AE-

aerate: ventumi, aerumi

affable: afabla

affair: afero, (infidelity) amafero

(to have an) affair: amaĵi

afflict: malĝojigi

afford: toleri la elspezon por

be afraid: timi

aft: pobe(n)

after: post, post kiam

afternoon: posttagmezo

afterwards, poste

again: denove, re(foj)e

against: kontraŭ

age: aĝo, epoko

agitate: agiti

agree: konsenti

agreement: konsento

ah!: ha!
AI-

aim: celi, celo

air: aero

air (appearance): mieno, aspekto

air (tune): ario

air condition: klimatizi

air conditioner: klimatizilo

air conditioning: klimatizado

air mattress: aermatraco?

air out: aerumi

aircraft: aerveturilo(j), aviadilo(j), aerplano(j)

airlock: aerkluzo

airport: flughaveno

airmail: aerpoŝte, -a, -o

airplane: flugmaŝino, aviadilo

airraid: aeratako

airsickness: aermalsano

airship: aerŝipo

ajar: malfermeta

alack!: ho ve!

alarm clock: vekhorloĝo

alas!: ho, ve!

album: albumo

alcohol: alkoholo

alert: vigla

algebra: algebro

alien: alinacia, -ano, fremda

alien (space): alimonda, -ulo, -ula, kosmano, eksterterulo

alive: vivanta,

be alive: vivi

all: ĉio, ĉiuj, la tuta

all the better: des pli bone

all weather tire: ĉiavetera pneŭo

alligator: aligatoro

allow: permesi

almost: preskaŭ

alone: sola, sole

all alone: solsola

along: laŭ

alpaca: alpako

alphabet: alfabeto

alphabetical: alfabeta

already: jam

also: ankaŭ

altarpiece: altartabulo

although: kvankam

always: ĉiam

amateur: amatoro, amatora

amaze: mirigi

be amazed: miri

ambassador: ambasadoro

ambulance: krizaŭto, ambulanco

America (continent): Ameriko

America, United States of,: Usono

americana: usonaĵo(j)

among(st): inter

amuse: amuzi

ancestor: prapatro

and: kaj

android: homaspekta roboto, androido

anger: kolero, kolerigi

angle: angulo

angry: kolera

animal: besto

animal (domestic): dombesto

animation: animacio

anorak: anorako

announce: anonci

announcement: anonco

annoy: ĉagreni

another: alia

answer: respondi, respondo

answer key: solvaro

ant: formiko

Antarctic: Antarkto, antarkta

anteater: formikomanĝulo

antelope: antilopo

antidote: kontraŭveneno

antiperspirant: kontraŭŝvitilo?

antique: antikva, antikvaĵo

any: ia, iu

anybody, anyone: iu (ajn)

anything: io (ajn)

anywhere: ie (ajn), ien (ajn)
AO-

aoudad: kolhara ŝafo, aŭado

apart from: krom

apartment(s): apartamento

ape: simio

aphid: plantlaŭso, afido

apocalypse: apokalipso

apparatus: aparato

appear: aperi, vidiĝi, (seem) ŝajni

appearance: aspekto

applaud: aplaŭdi

apple: pomo

apple juice: pomosuko

apple pie: pomotorto

apple tree: pomarbo, pomujo (archaic)

appreciate: ŝati

approve: aprobi

approximate: proksimuma

April: aprilo

arbor: laŭbo

arch: arkigi, arkiĝi

arch: arkaĵo

arch- (chief-): ĉef-, arĥi-

Arctic: Arkto, arkta

argali: altaja ŝafo, argalo

arithmatic: aritmetiko

arm: brako, fortelo

armadillo: dazipo

armchair: brakseĝo

armpit: akselo

arms (weapons): armiloj

around: ĉirkaŭ, ĉirkaŭe

around the corner: laŭ la angulo

arouse: veki

arrange: aranĝi

arrest: aresti

arrival: alveno

arrive: alveni

arrow: sago

art: arto

artichoke (globe): artiŝoko

article (magazine): artikolo, (thing) objekto

arvo (AU): posttagmezo

as: kiel

as if: kvazaŭ

ashamed: (be ashamed) honti

Asia: Azio

Asian: azia, aziano

ask: (question) demandi, (request) peti

asleep: (be asleep) dormi

ass: azeno

ass, arse (BR): postaĵo, pugo

assimilate: asimili

assimilation: asimilo, asimilado

assume: supozi

at (at the rate of): po

at (by reason of): pro

at (close by): apud

at (concerning): pri

at (in): en

at (of place, when no motion is expressed): ĉe

at (of time): je

at (to, towards): al

at any rate (at least): almenaŭ

at first: unue, komence

at hand (near): proksime

at last: fine

at least: almenaŭ

at least (no less than): minimume

at length: fine

at once (immediately): tuj

at present: nune, nuntempe

at that (thereupon): je tio

athlete: atleto

Atlantis: Atlantiso, Atlantido

atom: atomo

atomic: atoma

attack: ataki

attain: atingi

attempt: peni

attend (be present): ĉeesti

attend (pay attention): atenti

attic: sub tegment(ej)o

attorney: advokato

attract: allogi

attractive: alloga, ĉarma
AU-

au pair (girl): gastvartist(in)o

audacious: maltima

audience: spektantaro

audiobook: aŭdlibro

August: aŭgusto

aunt: onklino

Australia: Aŭstralio

Australian: aŭstralia, aŭstraliano

Austria: Austrujo, Aŭstrio

Austrian: aŭstra, aŭstro

author: verkinto

autostop: memmalŝalto

autumn: aŭtuno

available: havebla

avenge: venĝi

aviation: aviado

avoid, evade: eviti

await: atendi

awake: vek(iĝ)i

(wide) awake: vigla

away: for

avenge, avenge oneself: venĝi

ax, axe: hakilo

aye: jes

aye: ĉiam

ayah: (hinda) vartistino

azalea: azaleo

azimuth: azimuto

Azores: Acoroj

Aztec: azteko, -a

azure: lazuro, -a 
babble: babileti (pri eta bebo)

baboon: paviano

baby: bebo

baby carrier: litkorbo

baby chair: beboseĝo

baby food: bebokaĉo, kaĉeto

baby monitor: bebokontrolilo?, bebofono

baby shower: (bebo)donacfesto

baby sitter: vartist(in)o, infanvartist(in)o

baby tooth: laktodento

baby walker: paŝlernilo, irigilo

baby wipe(s): bebviŝilo(j)

bachelor: fraŭlo

bachelorette: fraŭlino

back: dorso, malantaŭo

backbone: spino

backgammon: triktrako

background: fono

background processing: fona reĝimo

backpack: dorsosako

backpacker: dorsosakulo

backsplash (in kitchen): (apudlavuja) muro

bacon: lardo

bacon rind: lardohauxto

bad: malbona

badge: insigno

badger (animal): melo

bag: sako, saketo, valizo

bagel: kringo

baggage: pakaĵoj

baggy: sakeca

bake: bak(iĝ)i

baked goods: bakaĵo

ball: pilko, (formed into) bulo

ball point pen: globkrajono

ball (dance): balo

ballad: kanzono

ballet: baleto

banana: banano

Band-Aid: pretpansaĵo, (glu)bandagxeto?

bandage: bandaĝo, -i

bandage, bind up: vindi

bank: (finance) banko, (of river) bordo

banquet: bankedo, festeno

bar: bari, barilo

bar (drink): trinkejo

bar (rod): kradstango

barbed wire: pikdrato, pikildrato

barefoot: nudpieda

bark: boji

barrier: barilo

base: bazo

baseball: basbalo, (basbal)pilko

basic: baza

basin: pelvo

basis: bazo

basket: korbo

bass (low voice): malalta

bat: bati, batilo

bat (animal): vesperto

batch: fornpleno

baterio: baterio

bath: bano, bani, (tub) bankuvo

bath mat: banmato

bath towel: bantuko

bathrobe: banrobo

bathe: bani sin, bani

bathroom: banĉambro, banejo, necesejo

battle: batalo, batali

battleground: batalejo

battleship: batalŝipo

bay window: alkova fenestro

bayonet: bajoneto
BE-

be: esti

be prepared! (scout slogan): estu preta!

(I'll) be right back: (mi) tuj revenos

beach: , marbordo, strando

bead: bido

beagle (dog): biglo

bean: fabo

bean (french): fazeolo:

bear: porti, (birth) naski

bear: urso

beat: bati

beatnik: bohemiano

beaver: kastoro

beaver (CB slang): virino

beautiful: bela

beauty: bel(ec)o, belul(in)o

because: ĉar

because of: pro

become: iĝi, fariĝi

bed: lito

bed (make (up) a): prepari liton, pretigi liton

bed (re-make a): reordigi liton, ordigi liton

bedfellow: litkunulo

bedroom: dormoĉambro, dormejo

bedsheet: lit(o)tuko

bedside table: lit(o)tabl(et)o

bedspread, counterpane: superkovrilo supra kovrilo

bee: abelo

beef: bovaĵo

beefsteak: bifsteko

beehive: abelujo

beekeeper: abelisto

beer: biero

beetle: skarabo, koleoptero

beetroot: ruĝa beto

before: antaŭ (ol), antaŭe

befriend: amike helpi, amikumi

beget: naskigi

begin: komenc(iĝ)i

beginner: komenceanto

behave: konduti, bone konduti

behind: malantaŭ

behold: jen

Belgian: belgo, belga

Belgium: Belgujo, Belgio

believe: kredi

belief: kredo

belittle: etigi

bell: sonorilo

belly: ventro

belly shirt: ventroĉemizo

belong: aparteni

below: sub

belt: zono

bench: benko

bend: fleks(iĝ)i

beneath: sub

bent: kurba

beside, near to: apud

besides: krom

best: plej bona, plej bone

best friend: plej bona amiko, plej intima amiko

best man: edziĝkunulo, honora fraŭlo

bet: veti, veto

betrayed husband (not applicable to wife): kokrito

better: pli bona, pli bone

between: inter

bevy: aro

beyond: preter
BI-

bib: salivtuko, antaŭtuk(et)o

Bible: Biblio

bicycle: biciklo

bicycle path: biciklovojo

bicycle rack, bicycle carrier: bicikloportilo

bidet: bideo

big: granda

bike: biciklo, bicikli

bike path: biciklovojo

bike rack: bicikloportilo

bilingual: dulingva

bilingual (person): dulingvulo

bill (hotel, etc.): kalkulo

bill-board, notice-board: afiŝtabulo

billfold: monujo

bin: ujo

bingo (game): bingo

bird: birdo

birdcherry: paduso

bird fancier: birdbredisto

bird house: birdodometo?

bird lime: birdogluo

bird's eye view: birdoperspektivo

birdbath: birdbanujo

birdseed: milio

birth: naskiĝo, naski

birthday: naskiĝtago

biscuit (BR): biskvito

biscuit, ring: kringo

bison: bizono

bit: peceto

bite: mordi, (snack) manĝeto

bitter: maldolĉa

black: nigra

blackboard, chalkboard: kretotabulo

blackberry (fruit): rubusbero

blackberry (computer): poŝkomputilo, kromcerbo

blame: kulpo, kulpigi

blanch, parboil: brogi

blank: blanka

blanket: (lan)kovrilo, litkovrilo

bleed: sangi

blender, mixer: miksilo, likvigilo

bless: beni

blessing: beno

blind: blinda

bliss: feliĉego

block, clog: ŝtopi

blog: blogo, -i

blogasphere: blogaro

bloke (BR)(AU): ulo

blood: sango

bloodhound: sangohundo

blouse: bluzo, virina ĉemizo

blow: bato, frapo, blovi

blow (a nose): blovumi nazon

blue: blua

blush: ruĝiĝi
BO-

boar: sovaĝa porko, apro

board, plank: tabulo

boarding pass: enirkarto

body: korpo

body language: korplingvo

boil: bol(ig)i

Bolivia: Bolivio

Bolivian: bolivia, boliviano

bolt: bolto

bolt (drink): glutegi

bolt (eat): manĝegi

bolt (fasten): rigli

bolt (fastener): riglilo

bolt (run): ekkuri

bone: osto

bonnet, cap: kufo

bonnet (of car) (BR): kapoto

bonus: kromsalajro, bonuso

booger, boogey: sekamuko, mukaĵo?

book: libro

book: rezervi, mendi, aĉeti (bileton)

book (register): registro

book bag: librosako

book cover: (libro)kovrilo

book shelf: librobreto

book case: librobretaro, libroŝranko

booking: rezervaĵo, mendo

booking office: giĉeto

bookish: studema, pedanta

bookkeeper: librotenisto

bookkeeping: librotenado

booklet: libreto, broŝuro

booklover: libramanto

bookmaker: vetperisto

bookplate: ekslibriso

bookseller: libr(ovend)isto

bookshop: libr(ovend)ejo

bookworm: librovermo, anobio

bookworm (person): legemulo

boombox: laŭt(muzik)ludilo?

boomerang (AU): bumerango

boot: bot(et)o

boot (of car) (BR): kofrujo

bootjack: senbotigilo

bootlace: botlaĉo

bootmaker: bot(far)isto

bootpolish: ciro

boottree: botstreĉilo

booty: rabaĵo

born: naskita, (be born) naskiĝi

borrow: prunti, pruntepreni

boss (chief): estro

boss (raised portion): boso

botch: fuŝi, fuŝaĵo

both: ambaŭ

bottle: botelo

bottle cap, bottle top: ĉapo

bottom: malsupro, malsupra

bow (and arrow): pafarko

bowl: bovlo

bowel: intesto

box: skatolo, kest(et)o

boxer (dog): boksero

boy: knabo

bra: mamzono

bracelet: brakĉeno

braid: plekti, (hair) harplekt(aĵ)o

brain: cerbo

braise: stufi

bran bread: branpano

branch: (tree) branĉo, (firm) filio

brassier: mamzono

brat: infanaĉo, bubaĉo

brave: kuraĝa

bravo!: brave!

Brazil: Brazilo

Brazilian: brazila, brazilano

bread: pano

bread roll: bulko

bread bin: panujo, pankonservujo

break: romp(iĝ)i, paŭzo

breakfast: matenmanĝo

breast: mamo

breast milk: patrina lakto, mamlakto

breastfeed: mamnutri

breath: spiro

breathe: spiri

brick: briko

bridal shower: (edziniĝ)donacfesto

bridge: ponto, (game) briĝo

brie (cheese): brio

brief: mallonga

bright: hela

brilliant: brila

bring: alporti

bring up (children): eduki

Britain: Britjuo, Britio

British: brita

Briton: brito

broad: larĝa

broadcast: dissendi, disaŭdigi

broccoli: brokolo

broke (without money): senmona

bronze: bronzo, -a

broom: balailo

brown: bruna

browser: krozilo

bruise: kontuz(aĵ)o, bluaĵo

brush: broso, brosi, peniko
BU-

buck: dolaro

buck (male deer): vircervo

bucket: sitelo

budgerigar, budgie: papageto

buffalo: bubalo

bug: artikpiedulo, artropodo, rampaĵo

bug, bedbug: cimo

bug (in computer program): cimo

build: konstrui

building: konstruaĵo

building block: brik(et)o, blok(et)o

built in (furniture, etc.): enkonstruita

bulb: bulbo

Bulgaria: Bulgario

Bulgarian: bulgara, bulgaro

bull: virbovo, taŭro

bulldog (dog): dogo

bullet: kuglo

bullet proof: kuglimuna

bungee jump: kaŭĉukasalti

bungee jumping: kaŭĉukasaltado

bungle: fuŝi

bunny: kunikl(et)o

bunk bed: dulito

burden: ŝarĝo, ŝarĝi

Burma: Birmo

Burmese: birma, birmano

burn: brul(iĝ)i

burp: rukteto

burst: krev(iĝ)i

bus: (aŭto)buso

business: afero(j), komerco

busy: okupita

but: sed

butter: butero, buterumi

butterfly: papilio

buttermilk: selakto

button: butono

buy: aĉeti

by: de, per, far, fare de

by heart: elkape, permemore

bye!: ĝis!
cab (taxi): taksio

cabby: taksiisto

cabaret: kabareto

cabbage: brasiko

cabin (of vehicle): cajuto

cable television, cable tv: kabla televido:

cafe: kafejo

caffeine: kafeino

cage: kaĝo, enkaĝigi

cajole: kaĵoli

cake: kuko

cake pan: bakformujo, bakmuldilo

calculate: kalkuli

calculator: (poŝ)kalkulilo

calendar: kalendaro

call: voki, voko

(be) called, named: nomiĝi

calm: trankvila

camel: kamelo

camera: fot(ograf)ilo

camp (out): kamp(ad)i, kamploĝi

camp (of tents): tend(ar)o

camp (place): tendejo

campground: tendejo, tendloko

can: povi

can: enladigi

can: skatolo, ujo, lad-skatolo, lado

can opener: elladigilo , ladskatol-malfermilo

Canada: Kanado

Canadian: kanada, kanadano

canary: kanario

candle: kandelo

candlestick: kandelingo

candelabra: kandelingaro

candy: dolĉaĵo(j), sukeraĵo(j)

candy bar: ĉokolada stango, dolĉaĵero?

candycane: pipromenta bastono

canned food, canned goods: ladmanĝaĵo

cannibal: kanibalo

canoe: kanuo

cap: ĉapo

capable: kapabla

cappuccino: kapuĉino

capture: kapti

capybara: akvoporko, kapibaro

car, automobile: aŭto, aŭtomobilo

car park (BR), car lot: parkejo

carafe: karafo

caravan: ruldomo

caraway: karvio

card: karto

cardboard: kartono, -a

care: zorgi, zorgo, prizorgo

(take) care of: prizorgi

career: kariero

careful: zorga, atentema

carefully: zorgeme

careless: senatenta

carob: karobo

carpet: tapiŝo

carriage, coach, (railway): vagono

carrot: karoto

carry: porti

carrycot (BR): litkorbo

cart: ĉaro

cart (serving): servoĉar(et)o

carve: skulpti, (meat) tranĉi

case: kovrilo, ujo, valiz(et)o

cash: mono

cashew: akaĵuo

cashier: kasisto

cassette: kasedo

cassette player: kasedilo

cassette recorder: kasedilo, magnetofono

cast iron: giso, muldfero, (muld)fera

cast iron cookware: ferkuiriloj

cast out: elĵeti

castle: kastelo

cat: kato

catch: kapti

caterpillar: papiliido, raŭpo

cathedral: katedralo

catholic: katoliko, katolika

catsup, catchup, ketchup: keĉapo, keĉupo

cauliflower: florbrasiko

cause: kaŭzo, kaŭzi, igi
[edit] CE-

cease: ĉesi, -igi

ceiling: plafono

celebrate: festi

cell phone, cellular telephone: poŝtelefono, ĉeltelefono

centipede: centpiedulo

central: centra

central heating: centra hejtado

centrifugal: centrifuga

century: jarcento

cereal: cerealo

certain: certa

cha-cha (dance): ĉaĉa

chain: ĉeno

chair: seĝo

chairman: prezidanto

chalkboard: kretotabulo

chameleon: ĥameleono

chamois: ĉamo

chance: hazardo, (of success) ŝanco

change: ŝanĝi, -iĝi

change (coins): moneroj

change (money remaining from a transaction): restmono

change baby: revindi

changing table: vindotablo, vartotablo

channel (television): kanalo

channel changer: kanalŝanĝilo

chapel: kapelo

chard, white beet: folibeto

charming: ĉarma

chaste: ĉasta

chat: babili, babilado

chayote, christophine: ĉajoto

cheat: friponi, -o

cheat, crook, rogue: fripono

check (hinder): malhelpi

check (chess): ŝaki, ŝak!

check (revise, verify): kontroli

check (stop): haltigi

check, cheque: ĉeko

check (control): kontrolo

check (hinderance): malhelpo

check (chess): ŝako

check (pattern): kvadratdesegno, -a

check (stoppage): haltigo

check (ticket): bileto, kontrolilo

check (off of list): krucmarki

checkers, draughts (game): damoj

checkmate: elŝaki, mati

checkmate: elŝako, mato

cheddar (cheese): ĉedaro

cheek: (face): vango

cheek (impertinence): impertinento

-cheeked: -vanga

cheeky (impertinent): impertinenta

cheep: pepi

cheerful: gaja, bonhumora

cheer leader: huraisto

cheese: fromaĝo

cheese (mature): matur(igit)a fromaĝo

cheetah: gepardo

chess: ŝako

chessboard, chess-board: ŝaktabulo

chessman: ŝakpeco

chest: kesto, brusto

chest freezer: kestofrostujo

chest of drawers: komodo, tirkestaro

chewing gum: maĉgumo

chick: kokideto

chick (girl): ulino

chicken: kok(in)o

chicken coop: kokokaĝaro

chicken pox: varioleto

chicory: cikorio

chief: ĉefo, ĉefa, estro

chihuahua (dog): ĉivavo

child: infano, ido

child prodigy: infana mirindulo

childbirth: akuŝo

childhood: infaneco

childish: infaneca

childless: seninfana

childlike: infana

Chile: Ĉilio

Chilean: ĉilia, ĉiliano

chimpanzee: ĉimpanzo

China: Ĉinio, Ĉinujo, Ĥinujo, Ĥinlando

chinchilla: ĉinĉilo

Chinese: ĉina, ĉino

chip (break): rompet(iĝ)i, rompeto

chip (chop): haketi

chip (broken piece): rompetaĵo

chip (piece chopped off): dehakaĵo

chips, potato chips: terpomflokoj, ĉipsoj

chips, corn chips: maiz(o)ĉipsoj?

chipmunk: striita sciuro, strisciuro, ĉipmunko

chive(s): ŝenoprazo

chocolate: ĉokolado

chocolate (hot): ĉokolado

choice: elekto

choir: ĥoro, koruso

choose: elekto

chop: haki

chop sticks: manĝbastonetoj

chow chow (dog): ĉaŭĉaŭ

Christ: Kristo

Christendom: la kristanaro

Christian: Kristano, -a

christian name: antaŭnomo, persona nomo

Christianity: kristanismo

Christmas: Kristnasko

chuckle: subridi

church (body): eklezio

church (building): preĝejo

church (christian): kirko

churchwarden: presbitero

churchyard: tombejo
[edit] CI-

cigar: cigaro

cigarette: cigaredo

cigarette holder: cigaredingo

cinema: kinejo

cinnamon: cinamo, -a

cinnamon roll: cinama bulko

circle: cirklo, rondo

city: urb(eg)o

civet: civeto

clamp: (ŝraŭb)premilo

clap: aplaŭdi

clasp: agrafo

class: klaso, kurso

classmate: kunklasano

clay: argilo

clean: pura

cleanse: purigi

clear: klara, hela

cleavage: fendiĝo

cleave (split): fend(iĝ)i

cleave (stick): al(glu)iĝi

clergyman: pastro

clever: lerta, inteligenta

climb: grimpi

cling wrap: volvoplasto

clipper: tondilo, (elektra) tondilo

cloak: mantelo

cloakroom: vestejo, vestodeponejo

clock: horloĝo

close: fermi

close by: proksima, proksime

cloth (for a purpose): tuko

clothe: vesti

clothes: vestoj

clothes hanger: vestarko

clothes pin, clothes peg: tukpinĉilo

cloud: nubo

club (strike with a club): klabi

club (society): klubo

club (at cards): trefo

club (weapon): klabo

club footed: bulpieda

clue: signo, indikilo

clueless: senidea
[edit] CO-

CO2 detector: CO2 detektilo

coach: aŭtobuso, vagono

coal: karbo

coast: marbordo

coat: mantelo

coati: nazurso, nazuo

coax: kaĵoli

cock: virbirdo, (rooster) koko

cocker spaniel: skolopa spanielo

cockroach: blato

cocoa: kakao, ĉokolado

coffee: kafo

coffee bean: kafograjno

coffee break: kafopaŭzo

coffee bush: kafoarbeto

coffee cake: kafokuko

coffee can: kafujo, kafskatolo

coffee cup: kafotaso

coffee filter: kafofiltrilo

coffeehouse: kafejo

coffee pot: kafkruĉo

coffee shop: kafovendejo

coffee table:kafotablo

coffeemaker: kafaparato

cohabitee (live-in) partner: kunvivant(in)o, kunul(in)o

coin (money): monero

coincidence: koincido

cola: kolao

colander: traverŝilo, elgutigilo, kribrilo

cold: malvarma, (illness) malvarmumo

collaborate: kunlabori

collaboration: kunlabor(ad)o

collar: kolumo

collect: kolekt(iĝ)i

college: kolegio

colonel: kolonelo

color, colour: koloro, kolori

color printer (computer): kolorpresilo

comb: kombi, kombilo

come: veni

comfort: komforto

comfortable: komforta

comic(al): komika

command: ordoni, ordono

commence:komenc(iĝ)i

comment: komenti, komento

commerce: komerca

commercial: komerca

committee: komitato

commodity: varo

common: ofta, ordinara, komuna

common sense: prudento

community: komunumo, socio

compact disc, compact disk, CD: kompakta disko, KD

companion: kunulo

company: kompanio

compare: kompari

compartment: fako

compass: kompaso

compel: devigi

compulsory: deviga

competition: konkurso

complain: plendi

complete: kompleta

complicate: kompliki

complicated: komplika

compost (fertilizer): kompoŝto, kompoŝti

compost pile: kompoŝtamaso

composter: kompoŝtujo

compote: kompoto

comprise: ampleksi

compute: kalkuli, komputi

computer: komputilo

computer game: elektronika ludo, videoludo

computer keyboard: (komputila) klavaro

computer monitor: (komputila) ekrano

computer printer: printilo

computer laser printer: lasera printilo

computer scanner: skanilo

concept: koncepto

concert: koncerto

concrete betono, -a

concrete (not abstract): konkreta

condition: stato, kondiĉo

conditioner: harbalzamo

coney: fajfleporo, pikao

confess: konfesi

confession: konfeso

congratulate: gratuli

congress: kongreso

conjunctivitis: (kontaĝa) konjunktivito

conquer: venki

consent: konsenti, konsento

consequence: sekvo

consequently: sekve

consider (be considerate to): prizorgi

consider (opine): opinii

consider (regard): rigardi

consider (think about): pripensi, konsideri

considerable (not a little): sifiĉa

considerable (worth considering): konsiderinda

consist (of): konsisti (el)

console: konsoli

console-table: konzolo

consort: kunuliĝi

consort (companion): kunulo

consort (spouse): edz(in)o

constable: simpla policano

constant: konstanta

constellation: stelaro, stelfiguro, konstelacio

construct: konstrui

consult: konsulti

container: ujo

content(ed): kontenta

contest: konkurso

continue: daŭr(iĝ)i, daŭr(ig)i

contrary: malo, mala, kontraŭa,

contrariwise, on the contrary: male

contrast: kontrasto

control: regi

controverse: polemiki

convenience: oportuno, necesejo

convenient: oportuna

convent: monaĥinejo

convention: konvencia

convention (meeting): kunveno

conventional: konvencia

conversation: konversacio, dialogo

convict: juĝpruvi, konvikti

cook: kuir(iĝ)i

cook, (chef): kuiristo

cook out: kuirpikniko

cookbook: riceptaro, kuirlibro

cooker: kuirforno

cookie (BR): biskvito, kuketo

cookie (US): biskvito

cookie sheet: bakpleto

cooking pot: kaldron, kuirpoto

cooking spoon: kuirkulero

cool: malvarm(et)a, malvamigi, malvarmiĝi

cool: aplomba, flegma

cool (slang): bona, bonuma, malaĉa

coolant: malvarmiga fluido

coolie: kulio

coop: kaĝo, korbo

cop: policano, kapti

copper: kupro, kupra

cops and robbers (game): kaptoludo

co-pilot, copilot: kunpiloto

copy: kopii, kopio, ekzemplero

cord: ŝnuro

cordial: kora

cordless phone: portebla telefono, senkabla telefono

cork: korko, ŝtopilo

corkscrew: korktirilo

corner: angulo

correct: korekti, ĝusta, senerara

correspond: korespondi, interskribi

correspondence: poŝtaĵo, korespondado

corridor: koridoro

cost: kosti: kosti, kosto

costume: kostumo, vesto, kompleto

costly: multekosta

cot (BR): kradlito

cotton ball: vato

cotton candy: sukervato

cotton swab: vatbastoneto

cougar: pumo

cough: tusi, tuso

count: nombri

countertop (kitchen): ŝrankotablo?

counting-out rhyme: nombradversaĵo, nombradrimaĵo

country: lando, kamparo

county (US): kantono

couple: paro

couple (join): kupli

coupon: kupono

courage: kuraĝo

courageous: kuraĝa

courgette, baby marrow: kukurbeto

course: kurso

court, woo: amindumi

courteous: ĝentila

cousin: kuz(in)o

cover: kovri, kovrilo, ampleksi

cover. lid: kovrilo

cover (book): kovrilo

cow: bovino

coyote: kojoto

cracker, pretzel?: krakeno

cradle: lulilo

craftsman: metiisto

crafty: ruza

cranberry: oksikoko

cranberry (dried, crasin): sekoksikoko

crash: frakasiĝi

crasin (dried cranberry): sekoksikoko

crawl (child): rampi

cream: kremo

cream (skin): haŭtkremo

cream, pommade, ointment: pomado

cream: ŝmiraĵo

cream cheese: kremfromaĝo

cream of tartar: tartratkremo

creamery: , laktejo, buterfarejo

create: krei

creation: kreaĵo

creator: kreinto

creche, kindergarten: infanejo, infanĝardeno, infanvartejo

creep: rampi

creepy-crawly: rampaĵo

crepe: krepo

crevasse: fendego

crevice: fendeto

crew (ship): ŝipanaro

crew (labor gang): laborantaro, laborantoj

crib: kradlito

cribbage (game): kribaĝo

cricket: akrido

crime: krimo

criminal: krimulo

crispbread: krakpano

crisps (BR): terpomflokoj, ĉipsoj

criticize: kritiki

crocodile: krokodilo

crook: fripono, krimulo

crook (shepherd's): hokbastono

crooked (hooked): hoka

crooked (not straight): malrekta

crop (cut close): tondi

crop (agricultural): rikoltaĵo

crop (of bird): kropo

crop (growth): kreskaro

crop (riding whip): rajdvergo

crop top: ventroĉemizo

cross: kruco, -i

cross oneself, make the sign of the fross: krucosigni

crossing (railroad): (fervoja) transirejo, reltransirejo

crossword puzzle: krucvortenigmo

crow: korvo

crowbar: (fera) levstango

crowd: (hom)amaso

crowbar, wrecking bar: rompbaskulo

crown: krono

cruel: kruela

crucifix: krucifikso

crucify: krucumi

crude oil: kruda petrolo

cruise: krozi

crumple: ĉifi

crush: premegi, -o, frakasi, pisti

crush (love): (unuflanka) ekam(eg)o, (unuflanke) ekam(eg)i, ekamiĝo, -i

cry: krio, krii, plori
[edit] CU-

cubit: ulno

cuckold: kokri

cuckoo: kukolo

cucumber: kukumo, (gherkin) kukumeto

culture: kulturo

cumin: kumino

cunning: ruza, ruzeco

cup: taso

cupboard: ŝranko

cupcake: kuketo

curator: kuratoro

cure: (re)sanigi

curious: scivola, (quaint) kurioza

current: korinta sekvinbero, korinta rosino

curry: kareo

curse: malbeni, malbeno

curtain: kurteno

curved: kurba

cushion: kuseno

cushion cover: kusensako

custom: kutimo

customs: dogano

cut: (with knife) tranĉi, (with scissor) tondi

cutting board: tranĉtabulo

cyan, aqua (color): ciano

Cyprus: Cipro

Czech: ĉeĥa

Czechoslovakia: Ĉeĥoslovakio

dachshund, sausage dog: melhundo

daddy, dad: paĉjo

dainty: delikata

dam: bari, baraĵo

damage: difekti, difekto

damn: kondamni

damn!: damne

damnable: damninda

dance: danci, danco, balo

Dane: dano

Danish: dana

danger: danĝero

dark: malluma, malhela

darkness: mallumo

darling: kara, karul(in)o

dart: sageto

data: datumo

database: datumbazo

date: dato, rendevui

dating service: svatservo?

daughter: filino

daughter-in-law: bofilino

day: tago

day care center, kindergarten: infanejo, infanĝardeno, infanvartejo

daydream: revo
[edit] DE-

deacon: diakono

deaconess: diakonino

dead: mortinta

deaf: surda

deal with: trakti pri

dear: kara

dear (expensive): multekosta

dearth: malsufiĉo, manko

death: morto

debark: elŝipiĝi

decaff: senkafeina

decanter: karafo

deceive: trompi

December: decembro

decide: decidi

decorate: ornami

dedicate: dediĉi

deep: profunda

deer: cervo

defeat: venki,  (a) defeat: malvenko

defend: defendi

defiant age: spitaĝo

define: difini

degree: grado, (university) licencio

delicate: delikata

delight: ravo, ravi

delightful: ĉarma, rava, oĵa (proposed word)

deliver: liveri

demand: postuli

Denmark: Danlando

dense: densa

dental floss: dent(o)fadeno

deodorant: senodorilo

department: fako

depend: dependi (de)

deposit: deponi, antaŭpago

depot: deponejo

debt: ŝuldo

department: fako

derailleur (bicycle): rilatumilo?

describe: priskribi

deserve: meriti

design: desegni, desegnaĵo

desire: dexiri

despair: malesperi, malespero

despite: malgraŭ

destiny: sorto

destroy: detrui

detergent: lesivo, deterganto

develop: evolu(ig)i

devote: dediĉi

dew: roso

dewdrop: rosero
[edit] DI-

dial a number: klavi numero, diski numeron

dialect: dialekto

dialogue: dialogo

diamond: diamanto

diaper, nappy: vindaĵo, vindo, vindotuko

diaper (a baby): vindi (bebon)

dice (game): ĵetkubo(j), lotkubo(j)

dice cup, dice box: kubĵetilo

dictionary: vortaro

die: morti

differ: diferenci

different: malsama, diversa(j)

dig: fosi

digit: cifero

digital camera: Cifereca fotilo?

digital video disc, DVD: DVD (dovodo), lumdisko

dildo: gadmeso, fikilo

diligent: diligenta

dill: aneto

dine: (vesper)manĝi

dingo (AU): sovaĝa hundo, dingo

dinner, supper: tagmanĝo, vespermanĝo

dip (for chips): trempaĵo?

direct: rekta

direction: direkto

disappear: malaperi

disc: disko

disciple: disĉiplo

Discman, portable CD player: poŝdiskilo, poŝdiskludilo

discus: (ĵet)disko

discuss: diskuti

dish: plado

dish rag: viŝtuko

dish towel: telertuko, sekigtuko

dish up: surpladigi

(the) dishes: la manĝilaro, vazaro

dishes, do the: lavi la manĝilaron, purigi la manĝilaron

dish washing liquid: vazlesivo, vazdeterganto

dishwasher: vazlavilo, vazlavmaŝino

display: (el)montri, (el)montro, spektaklo

disrobe: malvesti

dissolve: solvi

distance: malproksimo, (interval) distanco

distant: malproksima, fora

distinguish: distingi

distinguished: eminenta

distract: distri

distracted: distrita

distress: ĉagreno, ĉagreni

distribute: disdoni

district: (region) regiono, (of city) distrikto, kvartalo

disturb: ĝeni

dive: plonĝi

divide: divid(iĝ)i

divine: dia

divorce: eksedz(in)igi, -igo
[edit] DO-

do: fari

do (state of health): farti, stati

do (first word at befginning of question): ĉu

do (be suitable): taŭgi

do (cheat) (BR): friponi

do (cook)(BR): kuiri
do (finish): fini

do (regale): regali

do (suffice): sufiĉi

do (emphatic aŭiliary): ja

do away with: forigi, mortigi

do up (repair): ripari

do up (renovate): renovigi

do with (to have to) (have relations with): rilatiĝi kun

do with (to have to), to concern: koncerni

do without (be content without): kontentiĝi sen, sen esti je

doctor: kuracisto, (title) doktoro

document: dokumento

doddering: kaduka

doe: (female deer) cervino

doff: demeti

dog: hundo

dog house: hundejo

doll: pupo

dollhouse: pupdomo

dollar: dolaro

dolly: ŝarĝrultabulo, ŝarĝrulilo

don: surmeti

donkey: azeno

domestic animal: dombesto

door: pordo

door mat, welcome mat: skraptapiŝo

doorbell: (pordo)sonorilo

doorstop: pordokojno

dot: punkto

double bed: dupersona lito

doubleplus ungood: duoble malbonega

doubles (dice): ĝemeloj, paro

doubt: dubi, dubo

douche: duŝi, -o

doughnut, donut: pastoringo

down: malsupre(n)

downpour (rain): pluvego

downstairs: malsupre(n), sube(n)

drag (pull): tiri

dragon: drako

dragonfly: libelo

draw: (pull) tiri, (picture) desegni

drawer: tirkesto

drawing-room: salono

dream: sonĝi, sonĝo, (day-) revi, revo

dress: vesti (sin), (woman's) robo

dress (a wound): pansi

dressing (on a wound): pansaĵo

drink: trinki, trinko, trinkaĵo

drinking fountain: trinkfonto

drinking glass: glaso, trinkglaso

drive: peli, (vehicle) veturigi, konduki

drop: fali, faligi, guto

drown: dron(iĝ)i

drip-dry: negladenda, pendsekigi, pendgutigi

drive (food, paper, etc.): kolektado

drug: drogo

drug (administer drugs to): drogi

drug (put narcotics into): narkotigi

drug (stupify): narkoti

druggist: drogisto

drum: tamburi

drum (cylinder): cilindro

drum (musical instrument): tamburo

drum (of the ear): timpano

drummer: tamburisto

drumstick: tamburilo

dry: seka, sekigi, sekiĝi

dry iron: sekgladilo
[edit] DU-

duck: anaso

duckling: anasido

dude: ulo

dudette: ulino

dumb: muta

dumb: stulta

dumpling: knedliko, knedlo, knedbulo, pastobulo

during: dum

dust: polvo, senpolvigi

duster: viŝtuko

dustpan: polvoŝovelilo

Dutch: nederlandano

Dutchman: nederlanda

duvet cover (BR): kovrilsako

dwell: loĝi 
each: ĉiu

eagle: aglo

ear: orelo

earring: orelornamo

early: frua, frue

earnest: serioza

earth: tero, grundo

earthquake: tertremo

earwig: forfikulo

ease: facileco

east: oriento

eastern: orienta

eastwards: orienten

Easter: Pasko

easy: facila

easily: facile

eat: manĝi

eating utensil: manĝilo

eavesdrop: subaŭskulti

ecology: ekologio

economize: ŝpari

edge: rando

edit: redakti

editor: redaktisto, redaktilo

edition: eldono

educate: eduki

education: edukado
[edit] EE-

eel: angilo

eelpout: lojto

eerie: tremiga

efficient: kapabla, efika

effigy: figuraĵo

effort: peno, klopodo, fortostreĉo

egg: ovo

egg (urge): instigi

ego: egoo

egress: eliro

egret: egreto

Egypt: Egiptujo, Egiptio

Egyptian: egipta, egipto
[edit] EI-

eight: ok

eighth: oka

either: aŭ ... aŭ

eject: elĵet(iĝ)i

elastic: elasta (fadeno)

elbow: kubuto

elbow: kubutpuŝi, kubuti, kubutumi

elbow-room: kubitlibereco, kubutspaco

elect: elekti

electric(al): elektra

electricity: elektro

elegant: eleganta

element: elemento

elementary school (US): bazlernejo, elementa lernejo

elephant: elefanto

elf: elfo

elfish: elfa

else: alia, alie

elvan: elfa

elvish (language): la elfa

emblem: emblemo

emboss: reliefigi

embossed: reliefa

embrace: brakumi

email: retpoŝto, -i

embroider: brodi

embroidery: brodaĵo

emerge: eliĝi

eminent: eminenta

emit: eligi

emperor: imperiestro

emphasis: emfazo

emphasize: emfazi

empire: imperio

empress: imperiestrino

empty: malplena, malplenigi

enamel: emajlo

encounter: renkonti, renkont(iĝ)o

end: fino, fin(iĝ)i

endeavor, endevour: peni, peno

endive: endivo

endure: elteni

enemy: malamiko

energy: energio

engine: motoro, maŝino, (railroad) lokomotivo

engine driver (BR): lokomotivestro

engineer (locomotive): lokomotivestro, maŝinisto

engineer: inĝeniero

engineering (profession): inĝenierarto

England: Anglujo, Anglio

English: angla

English language: angla lingvo, anglalingva

Englishman: anglo

enigma: enigmo

enjoy: ĝui

enjoy oneself: amuziĝi

enough: sufiĉa, sufiĉe (da)

ensue: sekvi

entertain: distri, amuzi

enthusiasm: entuziasmo

enthusiastic: entuziasma

entire: tuta

entirely: tute

entrance: eniro, enirejo, (highway) enirvojo

envelope: koverto

envoy: mesaĝisto
[edit] EO-

epoch: epoko

equal: egala

equally: egale

era: erao

erase: forskrapi, forviŝi

eraser: skrapgumo

ere: antaŭ (ol)

ere long: post nelonge

err: erari

errand: komisio

errand-boy: sendknabo

error: eraro

eschew: eviti

especial: aparta

essence: esenco

essential: esenca, nepra

esteem: estimi, estimo
[edit] EU-

euro: eŭro

Europe: Eŭropo

European: eŭropa, eŭropano

evade, avoid: eviti

eve (day before): antaŭtago

eve (evening): vespero

even: eĉ

even (level): ebena

even (of numbers): para

even: paid-up: kvita

evening: vespero

event: okazaĵo, evento

ever: iam, ĉiam

every: ĉiu

everybody: ĉiu

everybody: ĉiutaga, ĉiutage

everyone: ĉiu

everyone's: ĉies

everything: ĉio

everywhere: ĉie

evident: evidenta

excercise-book: kajero

exit (go out): eliri

exit (going out): eliro

exit (way out): elirejo

exit (from highway): el(ir)vojo

evil: malbono, -a

ewe: ŝafino

ewer, jug, pitcher: kruĉo

ex-: eks-

exact: ĝusta, preciza

exaggerate: troigi

examination: ekzameno

examination, exam (school): ekzameno

examine: ekzameni

example: ekzemplo, (for...) ekzemple

excavator: fosmaŝino

excellent: bonega

excess: troaĵo, troaĵeco

exclaim: ekkrii

exclude: ekskluzivi

excrement: ekskremento, fekaĵo

excursion: ekskurso

excuse: pardoni

excuse me!: pardonu!, pardonon!

exercise: ekzerco, ekzerci (sin)

exhaust: elĉerpi

exhausted: elĉerpita

exhibition: ekspozicio

exist: ekzisti

exit: eliri, eliro, elirejo

exit (highway): elirvojo

exodus: elirado

Exodus: Eliro

expect: atendi, antaŭvidi

expensive: multekosta

experience: sperto

experienced: sperta

expert: sperta, spertulo

explain: klarigi

explanation: klarigo

explode: eksplodi

exploit: ekspluati, heroaĵo

explore: esplori

expression: esprimo, (of face) mieno

extend: etend(iĝ)i

extension cord (elec): plilongiga (elektra) ŝnuro

extensive: ampleska

extinguish: estingi

extract: eltiri

extreme: ekstrema

extremely: (tre)ege

eye: okulo

eyelet: trueto

eyelid: palebro

eyesight: vidpovo, vidkapablo

eyesore: okul-ofendaĵo, okuldorno

explosion:eksplodo

eyeglasses: okulvitroj, oklo (proposed word) 

fable: fablo

fabric: teksaĵo, strukturo

fabricate: falsi, fabriki

fabulous: fabela

facade: fasado, ŝajno

face: vizaĝo, fronti, -o, faco, tegi

face value: nominala valoro

facet: faceto

facetious: ŝerca, -ema

facial, vizaĝa

'the facilities': necesejo

fact: fakto

(in) fact, factually: fakte, efektive

factory: fabriko

fail: malsukcesi

(without) fail: nepre

fair: justa

fall: fali, falo

Fall (Autumn): Aŭtuno

false: malvera, falsa

family: familio

famous: fama

fan: ventolilo

fan, aerate: ventumi

far: malproksima, malproksime(n)

farm: farmbieno, farmi

farmer: farmisto, kampulo

farmhouse: biendomo

fart: furzi, -o

(old) fart: oldulo

fashion: modo

fashionable: laŭmoda

fast: rapida, rapide, (clock) frua

fat: dika, grasa, graso

fate: sorto

father: patro

father-in-law: bopatro

fault: neperfektaĵo

(my) fault: mia kulpo

favor, favour: komplezo

favorite, favourite: preferata

fax: faksi, -o, telekopii, -o

fax machine: faksilo, telekopiilo
[edit] FE-

fear: timi, timo

feast: festo, (banquet) festeno, bankedo

feather: plumo

February: februaro

feed: nutri, manĝ(ig)i

feedback: reago

feedback (sound): retrokuplado

feel (emotion): senti

feel (touch): palpi

felt: felto, -a, -i

female: ino, ina

fence: palisaro

fennel: fenkolo

ferry: pramo, pramŝipo

fetch: venigi, alporti, alkonduki

fetching: ĉarma

fever: febro

few: malmultaj, (a few) kelkaj
[edit] FI-

fiction: fikcio

fictional: fikcia, malvera, neaŭtenta

field: kampo

fig: figo

fig tree: figarbo

fight: batali, batalo

figure: cifero, (form) figuro

file (tool) fajlilo

fill: plenigi, pleniĝi

fill (satiaty): sato

fill (a tooth): plombi

filling (of a tooth): plombo

filly: ĉevalidino

film, movie: filmo

final: fina

find: trovi

fine: bela, delikata

fine (penalty): monpuno

finger: fingro

finish: fin(iĝ)i

Finn: finno

Finland: Finnlando

Finnish: finna

fire: fajro

firefly: lampiro

firm: firma, (commercial) firmo, firmao

fish: fiŝo, fiŝkapti

fish (meat): fiŝaĵo

fist: pugno

fisticuffs: interpugnado

fit: (suitable) taŭga

fit (healthy): sana

five: kvin

fix: fiksi

flag: flago, (military) standardo

flame diffuser: kaserolsubtenilo, flamreto

flammable: brulema

flannel (BR): lavtuketo

flapjack: krespeto

flashlight: poŝlampo

flashdrive, USB: (USB-)poŝmemorilo, memorstango

flat: (smooth) plata, (level) ebena

flat tire: malŝvela penŭo

flatter: flati

flattery: flatado

flea: pulo

flee: fuĝi

fleet: ŝiparo

flight feather: flugplumo

flip mino: poŝfilmilo

flip-flop, thong (shoe): zorio

flipper (swimfin): (artefarita) naĝilo

flipper (on fish): naĝilo

flipper (pinball): puŝilo

float: flos(ig)i

float (parade): paradkamiono?

flock: aro

floodlight: verŝlumilo

floor: planko, (storey) etaĝo

floss (dental): dentofadeno

floss (the teeth): fadenpurigi

flour: faruna

flow: flui

flower: floro, flori

fluent: flua

flunkey: lakeo

flush (redden): ruĝiĝi

flush (with water): gargari

fly: flugi

fly (house): muŝo

fly agaric: muŝa amanito, muŝfungo

flypaper: muŝpapero

fly swatter: muŝfrapilo?
[edit] FO-

foal: ĉevalido, azenido

foam rubber, plastic foam: ŝaŭmplasto

fog: nebulo

fogy: kadukulaĉo

fold: fald(iĝ)i

folding chair: faldseĝo

follow: sekvi, (as follows) jene

food: manĝaĵo, nutraĵo

food drive: manĝaĵokolektado

fool (deceive): trompi

fool (jest): ŝerci

fool (play the fool): arlekeni

fool (foolish person): stultulo, idioto, malsaĝulo

fool (jester): ŝercisto

fool of, to make a (deceive): trompi

fool of, to make a (make ridiculous): igi ridinda, ridindigi

foolery: petolado

foolhardy: fikuraĝa

foolhardiness: fikuraĝo

foolish: malsaĝa

foot: piedo

foot (ca. 30 cm): futo

football (US): Usona futbalo, (Usona futbal)pilko

football, soccer: futbalo, (futbal)pilko

footbridge: piedponto, ponteto

for: por

for (according to): laŭ

for (as): kiel

for (as regards): pri

for (because): ĉar

for (during): dum

for (in exchange for): kontraŭ, por

for (in spite of): spite

for (instead of): anstataŭ

for (on account of): pro

for (on behalf of): por

for (towards): (en direkto) al

for a while: dumtempe

for ever (continually): ĉiam

for ever (for eternity): je eterno, por ĉiam

for example: ekzemple

forbid: malpermesi

forbidden: malpermesata, malpermesita

forecast: prognozo

forefather(s): prapatro(j)

foreground: (screen color): malfono

foreign: fremda, alilanda, eksterlanda

forest: arbar(eg)o

forget: forgesi

forgive: pardoni

fork: fork(et)o, manĝoforko

form: formo, (paper) aliĝilo, mendilo, etc.

formal: formala, solena

fortunate: feliĉa

fortunately: feliĉe

found (establish): fondi

foundation: fundamento, fondiĝo, fondaĵo

fountain: fontano

fountain pen: fontplumo

four: kvar

fourth: kvara

fraction: frakcio, ono

France: Francujo, Francio

frank: malkaŝ(em)a

frankincense: olibano

free: libera, senkosta, liberigi

freebie: senpagaĵo

freeze: frosti, (food) frostigi

freezer: frost(ig)ujo, fridegujo

French: franca

Frenchman: franco

french bean: fazeolo

(french) fries: fritoj, terpomfingroj

frequent: ofta

fresh: freŝa

Friday: vendredo, (Good Friday) Sankta Vendredo

fridge: glaciŝranko, fridujo

friend: amiko

friend (fellow Esperantist): samideano

(best) friend: plej bona amiko, plej intima amiko

friendless: senamika

friendliness: amikeco

friendly: amika

friendship: amikeco

frighten: timigi

frisbee: flugdisko, luddisko

frivolous: frivola

frog: rano

from: de, el

front: antaŭo, (in front of) antaŭ

frosted glass: laktovitro

fruit: frukto

fruit juice: fruktosuko

fruit juice with pulp: pulpsuk, kaĉosuko

fry: friti

frying pan: pato, fritilo
[edit] FU-

fuck: fiki, fik!

fulfill: plenumi

full: plena, (satiated) sata

very full: plenplena

fun: amuzo

function: funkcio

fund: kaso

fundamental: fundamenta

funnel: enverŝilo

funny: amuza, komika

furnace: forno

furniture: mebloj, meblaro, (piece of furniture) meblo

further: plu 

gadget: umilo

gain: gajni

gain: (clock) frui

gal: virino, ulino

gallery: galerio

gallop: galopi, galopo

galore: abunde

game: ludo

game controller, game pad: ludmantenilo

gangway, gangplank: paŝtabulo

garage: aŭtejo, auxtoriparejo

garbage bag: rubosako

garden: ĝardeno

gargle: gargari

garlic: ajlo

garlic press: ajlopremilo

garment: vesto

gas: gaso

gas, gasoline: benzino

gas detector: (gas)flarilo, gasdetektilo

gas station: benzinvendejo, benzinstacio

gas tank: benzinujo

gate: (ĝarden)pordo, (of town) pordego, (in fence) barilpordo

gather: kolekt(iĝ)i, amasigi, amasiĝi
[edit] GE-

Geiger-counter: Gejger-nombrilo

gelatin (jello): (fruktagusta) gelateno

general: ĝenerala (in general) ĝenerale

generous: malavara, donema

genius: genio, geniulo

gentle: milda, dolĉa

gentleman: sinjoro

German: germana, germano

Germany: Germanujo, Germanio

get (acquire): akiri

get (arrive): alveni

get (become): iĝi, fariĝi

get (catch): kapti

get (cause, cause to be): igi, -igi

get (fetch): alporti, havigi

get (hit): trafi

get (procure): havigi

get (prepare): prepari, pretigi

get (receive) ricevi

get along (progress): progresi

get away: foriĝi

get back (return): reveni

get down: malsupreniri, deiri

get in (enter): eniĝi, eniri

get in (collect): kolekti

get in (procure): havigi

get off (get free): liberigi, liberiĝi

get off (dismount): deiri

get on (agree): akordi

get on (do well): bonstati

get on (go forward): antaŭeniri

get on (mount): suriĝi (sur)

get on (progress): progresi

get on (prosper): prosperi

get on with (continue): daŭrigi

get out: eligi, eliĝi

get out (prepare): prepari

get out (publish): eldoni

get out of (avoid): eviti

get over (deceive): trompi

get over (overcome): venki

get over (pass through successfully): bone trapasi

get over (recover from): restatiĝi de

get rid of: sin liberigi de

get around (wheedle): kaĵoli, flatlogi

get through: trairi

get through (finish, carry out): fini, plenumi

get to (reach): alveni al

get together: renkontiĝo, -i

get up (arrange): aranĝi

get up (arise): leviĝi

get up (ascend, mount): supreniri

get up (dress up): kostumi

get up (from bed): ellitiĝi

get up (learn): lerni

get up (organize): organizi

get up (prepare, get ready): prepari, pretigi

gherkin: kukumeto

ghost: fantomo, spirito
[edit] GI-

gift: donaci, talento

gifted: talenta

gig (music, etc.): prezento

gild: orumi

giraffe: ĝirafo

girl: knabino

give: doni, (present) donaci

glad: ĝoja, (be glad) ĝoji

glance: ekrigardi, ekrigardo

glass (drinking): glaso

glass (looking): spegulo

glass (window): vitro

glass (smoked): fum(o)vitro

glasses (eye): okulvitroj, oklo (proposed word)

global warming: tervarmiĝo

globe: globo

globe (of the world): terglobo

glorious: glora, belega

glory: gloro

glove: ganto

glow worm: lampiro

glue: gluo, -i
[edit] GO-

go: iri, (vehicle) veturi

god: dio

goddess: diino

gold: oro

golden: ora

golden retriever: orkolora reporthundo

goldfish: orfiŝo

good: bona

good-bye: ĝis (la) revido, ĝis la, ĝis, adiaŭ

gorgeous: grandioza, belbela, oĵa (proposed word)

govern: regi

government: registaro

gown: robo

grace (prayer said before meal): tablopreĝo

grade: grado

grade, mark (in school): noto

grammar: gramatiko

grammar school: gimnazio

gramophone: gramofono

grand: grandioza

granddaughter: nepino

grandfather: avo

grandmother: avino

grandparents: geavoj

grandsire: avo

grandson: nepo

granny: ainjo?

grape: vinbero

grass: herbo, herbaro (see: lawn)

grasshopper: lokusto

grate (making a grating sound): grinci

grate (rasp): raspi

grate (firegrate): fajrujo

grateful (pleasing): plaĉa

grateful (thankful): danka

grater: raspilo

grated coconut: kokosa raspaĵo

grater: raspilo

grease: graso

greasy: grasa

great: granda

great- (of relationship): pra-

greatcoat: palto

great dane: danhundo

great grandfather: praavo

Greece: Grekujo, Grekio

Greek: greka, greko

green: verda

Greenland: Groenlando

greet: saluti

greeting: saluto

gray, grey: griza

grief: malĝojo, aflikto

grill (cooking): kradrostilo

grilled cheese sandwich: rostita fromaĝasandviĉo?

grinder: muelilo

groan: ĝemi

grocer: spicisto?

grocery store: manĝovendejo

ground: tero

groundhog: (arbara) marmoto

group: grupo

grow: kresk(igi)

grow up: plenkreskiĝi

gruel, milk pudding: laktosupo
[edit] GU-

guarantee: garantii

guard: gardi, gardisto

guard dog: gardhundo

guess: diveni, diveno

guest: gasto

guide: gvidi, gvidanto, gvidlibro, skoltino

guide dog: gvidhundo

guidebook: gvidlibro

guilty: kulpa

guinea pig: kabajo

gun: pafilo

gun dog: ĉashundo

gun powder: pulvo

gut, intestine: intesto

gut: senintestigi

guts: intestoj, internaĵoj, braveco?

guy: viro, ulo 

habit: kutimo

hail (weather): hajlo

hailstone: hajlero

hair: haroj, hararo, (single strand) haro

hair dryer: hararsekigilo

haircut: harartondado?

hairdresser: frizisto

half: duono, (as prefix) duon-

hall: vestiblo, antaŭĉambro

hallo: saluton

halt: halt(iĝ)i

halyard: hisilo

ham: ŝinko

hamburger: burgero, hamburgero, hamburgaĵo

hammer: martelo, marteli

hamster: hamstro

hamster ball: hamstropilko

hand: mano, mandoni

hand (of clock): montrilo

hand towel: mantuko

handbag: mansaketo

handbook: manlibro

handful: plenmano

handle: tenilo

handle (knob): anso

handle: tusxi, manipuli, trakti

handshake: manpremo

handsome (describing a man): virbela

handkerchief, hanky: poŝtuko, naztuko

hang: pend(ig)i

hang (execute): pendumi

hang (wall paper): tapeti

hangover: postebrio

hanky-panky: (kaŝ)ruzado

happen: okazi

happy: feliĉa

harbor, harbour: haveno

hard (not soft): malmola, dura

hard (not easy): malfacila

hard working: diligenta

harden off (plants): hardi (kontraŭ frosto)

hardly: apenaŭ

harm: malutili, malutilo

harmful: malutila

harvest: rikolto, rikolti

hash brown(s): terpombuleto(j)

hat: ĉapelo

hatch: gliĉeto

have: havi

have to: devi

hazelnut: avelo
[edit] HE-

he: li

head: kapo, ĉefo, estro

headache: kapdoloro

heading: titolo

head louse: homlaŭso, pediko

headphone(s): kapauskultio(j), aŭskultilo(j)

headstone: tomboŝtono

heal: (re)sanigi, (re)saniĝi

health: sano

healthy: sana

heap: amaso

hear: aŭdi

hearing aid: fonoforo

heart: koro

heart attack: koratako

hearth: kameno, fajrejo

heat: varmo, varmigi, hejti

heavy: peza

heel: (foot) kalkano, (shoe) kalkanumo

heifer: bovidino

hello!: saluton!

help: helpi, helpo

helpless: senhelpa, senpova

hen: kokino

her: ŝi, ŝin, ŝia

hers: ŝia

herb, grass: herbo

herb salt: herbsalo

here: ĉi tie(n)

here and there...: jen kaj jen...

here are: jen

here is: jen

heritage: heredaĵo

hermitage: ermitejo

hero: heroo

heroine: heroino

heroic: heroa

hesitate: heziti

hey!: he!, hej!
[edit] HI-

hi!: saluton!

hide: kaŝ(iĝ)i

high: alta, alte

high chair: infanseĝo

highway: ĉefvojo, aŭtovojego, ŝoseo

hill: monteto, (slope) deklivo

him: li, lin

hinder: malhelpi

hip: kokso

hip-huggers (jeans): koksaĝinzo?

hipsters (jeans): koksaĝinzo?

his: lia

history: historio

hit (song): furorkanto, modkanto,ŝlagro

hitch-hike: petveturi
[edit] HO-

hobby: ŝatokupo, flankokupo, hobio

hoe: sarki, -ilo

hoist (halyard): hisilo

hoist (up): hisi

hold: teni

hold (contain): enhavi, enteni

hold (have): havi

hold (possess): posedi

hold (opine, consider): opinii

hold: teno

hold (of ship): holdo

hold!: haltu!

holder (for gripping): tenilo

holder (for inserting object): ingo

holder (receptacle): ujo

hole: truo

holiday (free day): libertago

holiday (public holiday): ferio

holiday(s) (vacation): libertempo, ferioj

holy: sankta

Holy Spirit: Sankta Spirito, Parakleto

home: hejmo, hejmen, (at home) hejme

homework: hejmtasko

honor, honour: honoro, honori

hood (car): (US) kapoto (BR) kapuĉo

hook: hoko

hope: esperi, espero

hope chest: edziniĝkesto

horizontal: horizontala

horse: ĉevalo

horseshoe: huf(o)fero

horseradish: kreno

hospital: malsanulejo, hospitalo

hostel: gastejo

hot: varma, varmega

hot dog bun: kolbasobulko

hot pepper: acidkapsiko

hot water bottle: varmakvujo

hotel: hotelo

hotplate: kuirplato

hour: horo

hourglass: sablohorloĝo

house: domo

house plant: potplanto

hovercraft: kusenveturilo, teraplano, ŝvebŝipo

how: kiel

how come (why): kial

how much: kiom

how many: kiom

however: tamen
[edit] HU-

huckleberry: mirtelo

hug: brakumi, ĉirkaŭbraki

hullo: saluton

humanity, mankind: la homaro

humble: humila

humor, humour: (mood) humoro, (funny) humuro

humus: humo

hunch: suspekto, ideo

hunchback: ĝibulo

hundred: cent

Hungarian: hungara, hungaro

Hungary: Hungarujo, Hungario

hunger: malsato

hungry: malsata

hunt: ĉasi, ĉaso, serĉi, serĉo

hurrah: hura, -o

hurray: hura, -o

hurricane: uragano

hurry: rapidi

hurt: dolori

husband: edzo

hymn: himno

hymnal: himnaro, himnlibro 

I: mi

ice: glacio

ice (cool with ice): glaciumi

ice (cover with sugar): sukerkovri, sursukeri

ice box: glaciŝranko

ice cream: glaciaĵo

ice cube: glaciero, glacikubo, glacipeco

iced tea: glacia teo

iced tea spoon: longtenila kulero

iceberg: glacimonto

icecicle: glacistangeto

Iceland: Islando

Icelander: islandano

icepop: sukglacistango

idea: ideo

ideal: ideala, idealo

idiot: idioto
[edit] IF-

if: se

if (whether): ĉu

ignore: ignori, malatenti?

ill: malsana

illegal: kontraŭleĝa

illustrate: ilustri

illustration: ilustraĵo

image: bildo

imagination: imago(povo)

imagine: imagi

imitate: imiti

immediate: tuja

immediately: tuj

immortal: senmorta

impale: palisumi, trapiki

impatient: malpacienca

inpetigo: impetigeno

impiety: malpieco

import: importi, importaĵo

import (meaningful): signifa

important: grava

importance: graveco

impossible: malebla

impress: imponi

impressive: impona

improve: plibonigi, -ĝi
[edit] IN-

in: en

in other words: alivorte

incest: sangadulto

inchworm: mezurulo, geometro

incline (slope): kliniĝo

inclination: emo

incline: klini, -iĝi

include: inkluzivi

inclusive: inkluziva, -e

indeed: ja

index: indekso, -i

index (in a book, etc.): indekso

index (indication): indiko

index (math, physics): indico

index finger: montrofingro

India: Hindujo

Indian: hinda, hindo

indicate: indiki

indication: indiko

indifferent: indiferenta

industrial: industria

industrious: diligenta

industry: industrio

infant: infaneto, bebo

infer: subkompreni

inflammation: brulumo

inflammable: brulema

inform: informi, sciigi

information: informo(j)

infuse: infuzi

ingredient: ingredienco

injure: vundi

injury: vundo

ink:inko

ink well: inkujo

inner tube (of tire): interna aertubo

innocence (ignorance): nescio

innocence (naivete): naiveco

innocence (purity): pureco

innocence: senkulpeco

innocent: senkulpa

innocent (ignorant): nescia, senscia

innocent (naive): naiva

innocent (pure): pura

inquiry: enketo

insist: insisti

instant (food or drink): tuj(pret)a

instead of: anstataŭ

instrument: instrumento

insulate: izoli

intelligent: inteligenta

intend: intenci

intention: intenco

intense, intensive: intensa

interest: interesi, intereso

interesting: interesa

internal: interna

international: internacia

internet: interreto

interval: paŭzo

intestine, gut: intesto

introduce (thing): enkonduki, (person) prezenti

intuition: intuicio

invade: invadi

invasion: invado

invent: inventi

inventor: inventisto

investigate: esplori

investigation: esploro, enketo

invite: inviti

I.O.U.: pagpromeso
[edit] IP-

ipod: (mopotri)ludilo, ipodo

Iran: Irano

Iranian: irana, iranano

Iraq: Irako

Iraqi: iraka, irakano

Ireland: Irlando

Irish: irlanda

Irishman: irlandano

irritable bowel disease: iritiĝema intestomalsano

irritable bowel syndrome: iritiĝema intestsimptomaro

iron (metal): fero

iron: gladilo

iron (dry): sekgladilo

ironing board: gladotabulo

irrational: malracia

is: estas

island: insulo

isolate: izoli

Israel: Israelo, (biblical) Izrael(o)

Israeli: israela, israelano

issue, publish: eldoni

it: ĝi

its: ĝia

Italy: Italujo, Italio

Italian: itala, italo

item: ero 

jack hammer: pneŭmata martelo

jacket: jako

jacks (game with jacks and small ball), (also known as jackstones, fivestones, onesies, knucklebones or snobs): steloj (kaj pilketo)

jail: malliberejo

jail (someone): enkarcerigi, enmalliberejigi

jailbird: karcerulo

jailer: (karcer)gardisto

jam (food): konfitaĵo

jammies, pajamas: piĵamo

January: januaro

Japan: Japanujo, Japanio

Japanese: japana, japano

jar: bokalo

jack (electrical or telephone): ĵako

jacket: jako

January: januaro


(blue) jeans: ĝinzo, ĝinso, ĵinso

jello: (see GELATIN)

jelly (food): ĵeleo

jerk: ulaĉo

jerk: ekskui, -o

jerk(spasm): spasmo

Jesus: Jesuo

jet (plane): jeto

Jew: judo

Jewish: juda


jigsaw (puzzle): kunmetenigmo, puzlo?

jitters: timtremo


job: okupo, profesio, tasko

join: kunigi, iĝi kun

join (become an adherent of): aliĝi

joiner: lignaĵisto

joinery (joiner's art): lignaĵarto

joinery (woodwork): lignaĵo

joke: ŝerco, ŝerci

journey: vojaĝo

joystick: stirstango


jib (sail): ĵibo

jingle: tint(ig)i


judge: juĝi, juĝisto

jug, pitcher: kruĉo

juggle: ĵongli

juice: suko

July: julio

jump: salti, salto

jump rope, skip rope: ŝnursalti

jumprope: saltŝnuro

June: junio

jungle: ĝangalo

just (fair): justa, (a moment ago) ĵus 

kale: brasiko

kangaroo: makropo, kanguruo

karaoke: Karaokeo

kayak: kajako


keep: teni, gardi, konservi

ken: kono

kerchief: kaptuko

kettle: boligilo

key: ŝlosilo

key a number: klavi numeron

keyboard (computer): (komputila) klavaro

keyring: ŝlosilringo


kick: piedbati

kick stand: (bicikla) apogilo

kill: mortigi

kilogram, kilogramme: kilogramo

kilometer, kilometre: kilometro

kind: speco, bona, afabla

kindergarten: infanejo, infanĝardeno, infanvartejo

kindness: afableco, komplezo

king: reĝo

kingdom: regn, reĝlando

kiss: kisi, -o

kitchen: kuirejo

kitten: katido

kiwi (fruit): kivo, kivifrukto

kiwi (bird): kivio

'Kleenex': (paper)naztuko

knack: lerto

knead: knedi

knee: genuo

knee cap: patelo

knee (someone): genuumi

knee-jerk reaction: senpensa reag(eg)o

knickers: kalsono

knife: tranĉilo

knit: triki

knitting needle: trikilo

knock: frap(iĝ)i, -o

knock (engine): marteli, -(ad)o

knock off (BR): fini la laboron

knock out: nokaŭti, -o

knock kneed: tuŝgenua, ikskrura

knock something together: (rapide) faraĉi, konstruaĉi

know: (a fact) scii

know (acquaintance): koni


koala: koalo

Koran: Korano

kowtow: adorsterniĝi


kudos: renomo, prestiĝo 
LA-

label: etikedo, i

lace (shoe): laĉo, laĉi

lack: ne havi, manko

(be) lacking: manki

lad: junulo

ladder: ŝtupareto

ladle: kulerego

lady: sinjorino

ladybird (BR): mariskarabo

ladybug: mariskarabo

lady's room: (virina) necesejo

lair: kuŝejo

lake: lago

lamp: lampo

land: (not sea) tero, (country) lando, (alight) surteriĝi, alteriĝi

landlubber: terul(aĉ)o

landscape: pejzaĝo

language: lingvo, lingvaĵo

lap (drink): lektrinki

lap (enfold): envolvi

lap (splash): plaŭdi

lap (in a race): rondiro

lap (knees): genuoj, intergenuo

lapdog: dorlothundo

lapel: refaldo

laptop computer: surgenua komputilo

larder: (manĝaĵo)ŝranko

large: granda

laser printer: lasera printilo

last: daŭri, lasta, fina

late: malfrua, malfru, mortinta

Latvia: Latvujo, Latvio

Latvian: latva, latvo

laugh: ridi, rido

laundry (room, place): vestolavejo, lesivejo

laundry (clothes): lavendaĵoj, lesivaĵo

laundry detergent: lavpulvoro, lesivpulvoro

lavatory: necesejo

law: leĝo

lawn: gazono, razeno

lawn mower: gazon(o)tondilo, (gazono)tondmaŝino

lazy: mallaborema, maldiligenta
[edit] LE-

lead: konduki, gvidi

lead (metal): plumbo

leaf: folio

lean, support, sustain: apogi

learn: lerni

learner: lernanto

leash: (konduk)ŝnuro

least: plej malgranda

(at) least: almenaŭ

leather: leda, -o

leave: lasi, forlasi

Lebanon: Libano

Lebanese: libana, libanano

leer, ogle: okulumaĉi

left (on the): maldekstre, (aviation) live

leg: kruro

legal: laŭleĝa

legible: legebla

lemon: citrono

lemon squeezer: citronpremilo

lemonade: limonado

lend: pruntedoni

lentil: lento

less: malpli (da)

lesson: leciono

let: permesi, lasi

letter: letero, (of alphabet) litero

lettuce: laktuko

level: nivelo

leverage: levpovo

lewd: malĉasta
[edit] LI-

library: biblioteko

Libya: Libio

Libyan: libia, libiano

lice (head): homlaŭsoj

lick: leki

lid: kovrilo

lid, top, catch, cap, cover, stopper, fastener: fermilo

lie: kuŝi

lie: mensogi

lieutenant: leŭtenanto

life: vivo

light: lumo, lumigi

light (in color): hela

light (not heavy): malpeza

light bulb: lumampolo

lightning: fulmo

lightning bug: lampiro

lightyear: lumjaro

like: simila (al)

like (appreciate): ŝati

like (wish, be willing): voli

like (in like manner to): simile kiel

-like (suffix): -simila(j)

lime (fruit): limedo

lime (linden tree): tilio

lime (mineral): kalko

lime juice: limedsuko

limekiln: kalkforno

limelight: kalklumo

limestone: kalkŝtono

line: linio, vico, ŝnuro

line trimmer: ŝnurtondilo

linoleum: linoleumo

link (internet): ligilo

lint (medical): ĉarpio

lint (pocket, navel): poŝlanugo

lint: lanugo

lint roller: lanugforigilo

lion: leono

lioness: leonino

lip: lipo

liquid: likva, likvaĵo

list: listo

listen: aŭskulti

literature: literaturo

Lithuania: Litovujo, Litovio

Lithuanian: litova, litovo

liter, litre: litro

little: malgranda, eta, malmulta, iomete

little finger, pinkie: etfingro, eta fingro

live: vivi (dwell) loĝi

living room: salono, loĝĉambro, familia ĉambro
[edit] LO-

lo!: jen!

load: ŝarĝi, ŝarĝo

loan: prunto, prunti

loathe: abomeni

local: loka

loch: lago

lock: ŝlos(iĝ)i, seruro

lock (canal): kluzo

locked in: enŝlosita

locknut: kontraŭŝraubingo

lodge: loĝi

lodgings: loĝejo

London: Londono

Londoner: londonano

lone: sola

lonely: soleca

long: longa, longe

long for: sopiri

at long last: finfine

loo: necesejo

look: rigardi, rigardo, aspekti, aspekto

look (direct the gaze): rigardi

look (have an appearance): aspekti

look (seem): ŝajni

look (gaze glance): rigardo

look (mien): mieno

look(s) (appearance): aspekto

look after (take care of): prizorgi

look at: rigardi

look for (expect): atendi

look for (search for): serĉi

look in (visit): (ek)viziti

look into (investigate): esplori

look like (resemble): simili

look on: rigardi

look out (pay attention): atenti

look out for (seek): serĉi

look out for (take care of): prizorgi

look out, to be on the: observadi

look over (look through): trarigardi

look to (trust): fidi al

look up (look for): serĉi

look up to (respect): respekti

-looking: aspekta

looking glass: spegulo

look-out (observer): observanto

loom (for weaving): teksmaŝino

loop: maŝo, maŝigi

loop (curve): rekurbo

loot: rabi, rabaĵo

lord (master): sinjoro

Lord (title of nobility): Lordo

Lord (the) (the Deity): (la) Sinjoro

LORD (all caps): Eternulo

lord it over (to): superestrumi

lordly: nobel(ec)a

Lord's Supper: Sankta Vespermanĝo

lose: perdi, (clock) malfrui

lose (one's way): vojerari

lost: perdis, perdita

get lost!: perdiĝu!

lot (a lot of): multaj, multe da

loud: laŭta

damnably loud: laŭtlaŭta

lounge (room): sid(o)ĉambro

louse: laŭso

love: ami, -o

lovely: bela, rava

lovely: ĉarma, oĵa (proposed word)

low: malalta, malalte

low cut jeans: koksaĝinzo?

low rider (jeans): koksaĝinzo?
[edit] LU-

lucky: bonŝanca, feliĉa

lullaby: lulkanto

lunch: tagmanĝo, lunĉo

lunch(eon): tagmanĝi, tagmanĝo

Luther: Luter

Lutheran: Luterano, Luteristo

Lutheranism: Luteranismo

    * (Words beginning with or containing 'U X' get converted to 'ŭ' so I put a space between the U and the X) 

Lu xemburg: Luksemburgo

lu xurious: luksa

lu xury: lukso

    * (Words beginning with or containing 'U X' get converted to 'ŭ' so I put a space between the U and the X) 

lyceum: liceo 

machine: maŝino

machine iron, mangle: kalandri

mackintosh: pluvmantelo

macrame: makramo

mad, rabid: rabia

madam: sinjorino

magazine: gazeto, revuo, magazino

magic marker: dikplumo

magnanimously: grandanime

magnet: magneto

magnetic: magneta

magnificent: grandioza

maid: fraŭlino, junulino, servistino 

(bar)maid: verŝknabino, kelnerino

(old)maid: maljuna fraŭlino

maid of honor: edziĝ-atestantino, fianĉinfraulino, honora fraŭlino, fianĉinamikino

maiden: junulino, -a

maiden (virgin): virgulino, virga

maiden (new, unused): neuzita, nova, freŝa

maiden (first): unua

maiden hair (fern): adianto

maidenhead (hymen): himeno

mail: poŝto, enpoŝtigi

main: ĉefa

majesty: reĝ(in)a, moŝto

majority: plimulto

make: fari, igi

make (up) a bed: prepari liton, pretigi liton

make up (apply): ŝminki

male: vir(seks)a

mall, shopping mall: vendejaro

mallet: maleo

man: viro

man (human being): homo

man (supply with men): provizi per viroj, virprovizi, provizi per homoj, homprovizi

man (piece in games): peco

man-of-war: militŝipo

mangle, machine iron: kalandri

mankind: la homaro

Man, Isle of: Manksinsulo

manage (to do something): sukcesi

manner: maniero

manners: ĝentileco

mantis: preĝakrido, manto

manufacture: fabriki, fabrikado

Manx: manksa

Manxman: mankso

many: multaj

map: mapo

maple: acero

maple syrup: acersiropo

marble: marmoro

March: marto

march: marŝi

margarine: margarino

mark, grade (in school): noto

marry: edz(in)iĝi, geedziĝi

martial art: luktosporto

mass: amaso

Mass: meso

master: mastro, estro, majstro, instruisto

masticate, chew: maĉi

match: alumeto

matchbook: alumetlibro

matchbox: alumetujo

matchless: senkompara

matchmaker: svatist(in)o

mate (AU): ulo, amiko

material: materialo, (cloth) ŝtofo

maternal: patrina

maternity ward: akuŝejo

mathematics: matematiko

matter: afero, gravi

mattress: matraco

mature: matura

Maunday Thursday: la Sankta Ĵaŭdo

May (month): majo

Maya: Majao, -a

mayhap: eble

mayonnaise:majonezo

mayor: urbestro
[edit] ME-

me: mi, min

meal (flour): faruno

meal (repast): manĝo

mealtime: manĝhoro

mealy: farun(ec)a

mealy mouthed: molbuŝa

mean (intend): intenci

mean (mean to say): voli diri

mean (signify): signifi

mean (average,middle): mez(aĵ)o

mean (average): meza

mean (contemptible): malestiminda

mean (ignoble): malnobla

mean (stingy): avara

meander: serpenti

meanwhile: intertempe

measure: mezur(iĝ)i

measuring cup: mezurtaso

measuring spoon(s): mezurkuler(et)o(j)

meat: viando

mechanical pencil: mekanika krajono

medicine: medikamento, (science) medicino

meek: humila

meet: renkont(iĝ)i, kunveni

meeting: kunveno, renkontiĝo

meh: ajne

melee: miksbatalo

melody: melodio

melon: melono

melt: fand(iĝ)i

member: membro, ano

memoirs: memoraĵoj

memorabilia: memoeendaĵoj

memorable: memorinda

memory: memoro

memory stick, USB flash drive: poŝmemorilo

menace: minaci, minaco

men's room, restroom: (vira) necesejo

mend: ripari

menfolk: viroj

menstruation, period: menstruo, monataĵo

mention: mencii

merely: nur

merit: merito, meriti

merry: gaja

mesa: tablomonto

message: mesaĝo

messy: malpura, malorda

metal: metalo, metala

method: metado

meter, metre: metro

Mexico: Meksiko, Meksikio

Mexican: meksika, meksikano
[edit] MI-

microphone: mikrofono

microwave: mikroonda

microwave (oven): mikroonda forno

midday: tagmezo, -a

middle: mezo, meza

middle-aged: mezaĝa

middle school, secondary school: mezlernejo

middle finger: mezfingro, meza fingro

microphone, mike: mikrofono

migrate: migri

migration: migrado

mild: milda

milady: monsinjorino

mile: mejlo

milestone: mejloŝtono

milk: lakto, melki

milk, skim milk: senkrema lakto

milk pudding, gruel: laktosupo

milkman: laktisto

milkshake: (ĉokolada, vanila, fraga) laktoskuaĵo

millimeter, milimetre: milimetro

million: milliono (da)

millipede: milpiedulo

milord: monsinjoro

mind: menso

mindful: memore

mine: (la) mia, minejo

minimum: minimumo, minimuma

minister (church): pastro

minute: minuto

miracle: miraklo

miraculous: mirakla

mirror: spegulo

miser: avarulo

miserly: avara

miss (allow to pass by): preterlasi

miss (feel the lack of): senti la mankon de

Miss (title): Fraŭlino

miss (miss one's aim): maltrafi

miss (missing an aim): maltrafo

missal: meslibro

missionary: misiisto

mist: nebuleto

mistake (misunderstand): malkompreni, miskompreni

mistake (one thing for another): erare preni, mispreni

mistake: eraro

mistaken: erara

(to be) mistaken: erari

mistletoe: visko

mistress: mastrino, instruistino

mite (insect): akaro

mite (coin): obolo

mite (particle): atomo

mite (small child): etul(in)o

mitten: duonganto?

mix: miks(iĝ)i

mixer, blender: miksilo, likvigilo

mixer, whisk: kirlilo, ŝaŭmigilo
[edit] MO-

moan: ĝemi

model railroading: skalfervojado

modeling clay, modelling paste: modlopasto

modern: moderna

mom: panjo

moment: momento

Monday: lundo

money: mono

monk: monaĥo

monkey: simio

monkey nut (BR): arakido

monkey wrench: universala ŝraŭbŝlosilo

monolingual: unulingva

monitor (computer): komputila ekrano

monsignor: monsinjoro

month: monato

mood: humoro

moon: luno

moorhen: galinolo

mop:  lavbalai,-ilo

mop up (wipe): (for)viŝi

mope: malgaji

more: pli (da)

more or less: pli-malpli

moreover: cetere

morning: mateno

mortar: pistujo

mosquito: kulo

most: plej, la pli multo de

moth: noktpapilio

mother: patrino

mother-in-law: bopatrino

mother's milk: patrina lakto, mamlakto

motor: motoro

motorcycle, motorbike: motorciklo

motorist: aŭt(omobil)isto

motorway: aŭtovojo, aŭtoŝoseo

mountain: monto

mountain range: montaro

mountaineer: montano

mouse: muso

mouse (computer): (komputila) muso

mouse around: musumi

mouse pad: musmato

mouse trap: muskaptilo

mouth: buŝo

mouth wash: gargaraĵo

move: mov(iĝ)i

movement, motion: movado

movie camera: filmilo

MP3 player: mopotriludilo

Mr.: s-ro

Mrs.: s-ino

movie: filmo
[edit] MU-

much: multe (da)

muck, ooze: koto, fango

mucus, snot: muko

mud: koto

mug: kafotaso

mug, beaker: trinkpoteto

mug (slang): vizaĝaĉo

mugging: rabatenc(ad)o, prirab(ad)o

mule: mulo

mule deer: mulcervo

Mum(my): panjo

municipal: urba

murky: malhelega

museum: muzeo

mushroom: fungo, agariko

mushroom cap: (funga)ĉapelo

music: muziko

musical instrument: muzikilo

musician: muzikisto

musk ox: ovibovo, ovibo

musket: muskedo

musketeer: muskedisto

musketry (shooting): pafado

must: devas

must (grape juice): mosto

must (mustiness): mucideco

must-have: havendaĵo

mustache: lipharoj

mustard (condiment): mustardo

mustard (plant): sinapo

musty: mucida

muzzle: buŝumo

my: mia

mystery: mistero 
nag: riproĉadi

nag (horse): (rajd)ĉevalo

nail: najlo

nail (finger/toe): ungo

name: nomo

namesake: samnomulo

napkin (paper or otherwise): (paper) buŝtuko

napkin (sanitary): menstrutuko

nation: nacio

national: nacia, ŝtata

nature: naturo

naught: nenio, (figure) nulo
[edit] NE-

near: proksima, proksime

nearly: preskaŭ

necessary: necesa

neck: kolo

necklace: kolĉeno

need: bezoni, bezono

needle (sewing): kudrilo

needlework: kudrado, kudraĵo

neglect: malzorgi

neighbor: najbaro, proksimulo

neither: nek, nor: nek <nek...nek>

neologism: novradiko, novvorto, novformo, neologismo

nephew: nevo

nerd: studemulo, (per interest) -emulo

net: reto

Netherlands: Nederlando

never: neniam

nevertheless: tamen

new: nova

New Zealand: Novzelando

New Zealander: novzedlandano

news: novaĵoj

newspaper: ĵurnalo

newt: trito

next: venonta, proksima
[edit] NI-

nice: bela, agrabla

niece: nevino

nickname: alnomo, -i, kromnomo, -i

night: nokto, nokta

(spend the) night: tranokti

night light: dormlumil(et)o

nightmare: inkub(sonĝ)o, premsonĝo

night table, night stand: lit(o)tabl(et)o

Nile (river): (rivero) Nilo

nine: naŭ

Nintendo DS: poŝludkonzolo

nipple: mampinto, (of bottle) cicumo
[edit] NO-

no: ne, nenia, neniu

no one: neniu

noble: nobla

nobly: noble

nobody's: nenies

noise: bruo

non-iron: negladenda

nonce: unufojo, -a?

none: neniu, neniom

nonsense: sensensaĵo

noodle (pasta): nudelo

noodle (pool): flosstango

noon: tagmezo

nor: nek

Norman: normanda, normando

Normandy: Normandio

north: nordo

northern: norda

Norway: Norvegujo, Norvegio

Norwegian: norvega, norvego

nose: nazo

nose (blow one's): senmukigi, blovumi

nose (have a runny): muki

nose ring: nazringo

not: ne

not at all: tute ne

not yet: ankoraŭ ne

note: noti, noto, bileto

notebook: notlibro

notepad: leterbloko, notbloko

noteworthy: rimarkinda, memorinda

nothing: nenio

notice: rimarki, anonco

notify: informi, sciigi

nougat: nugato

nourish: nutri

now: nun

now (interjection): nu

now! (interjection): tuj!

nowhere: nenie(n)
[edit] NU-

nude: nuda, senvesta

nude (person): nudul(in)o

number (amount): nombro, (figure) numero

nurse: flegist(in)o

nurse, breastfeed: mamnutri

nut: nukso

nut: ŝraŭbingo

nut cracker: nuksorompilo 

oak(tree): kverk(arb)o, glanarbo

oar: remilo

oats: aveno

oats (porridge): avenflokoj

obese: dikdika

obey: obei

object (thing): objekto

object (aim): celo

oblige (be obliged to): devi

oblivion: forgeso, senkonscienco

observe: observi

observer: observanto, observisto

obstacle: baro, malhelpo, obstaklo

obstruct: obstrukci

obstruction: obstrukco

obtain: akiri, ricevi

obvious: evidenta, memevidenta

occasion: okazo

occupy: okupi

occupied: okupita

occur: okazi

ocean: oceano

October: oktobro

octopus: polpo

odd (extra): ekstra

odd (miscellaneous): diversa

odd (not even): nepara

odd (queer): stranga

oddity (oddness): strangeco

oddity (person): strangulo

odd-job man: faktoto
[edit] OE-

of: de, (quantity) da

of course: kompreneble

off: de (sur)

offer: proponi

office (function): ofico

office (place): oficejo, kontoro

officer (forces): oficiro

official: oficiala, funkciulo, oficisto

offspring: ido(j)

often: ofte

ogle, leer: okulumaĉi

oh: ho
[edit] OI-

oil: oleo

ointment, cream, pommade: pomado

ointment: ungvento

okay, OK: bone, en ordo, aprobi

old: malnova, maljuna

old fashioned: malmoderna

old fogie: malmodulo?

oldster: maljunulo, eksjunulo

olive oil: olivoleo

on: sur, (day) je

on the way: survoja, -e

on/off switch: ŝaltilo

once: (not twice): unufoje, (not now) iam

once in a great while: fojfoje

one: unu, oni

onion: cepo

only: nur, sola, sole

onus: ŝarĝo, respondeco
[edit] OO-

oops!: fuŝ!

ooze, muck: koto, fango

open: malferm(iĝ)i, malfermita

opera: opero

operate: funkc(iĝ)i, operacii

operation: operacio

opponent: kontraŭulo

opossum: didelfo

opportune: oportuna

opportunity: okazo, ŝanco

oppose: kontraŭ(star)i

opposite: kontraŭ, kontraŭa, malo

oppositely: male

or: aŭ

orange: oragnĝkolora

orange (fruit): oranĝo

orange juice: oranĝosuko

orangutan: orangutango

orchard: fruktoĝardeno, fruktarbejo

orchestra: orkestro

order: (command) ordoni, (goods) mendi

ordinary: ordinara

organization: organiz(aĵ)o

organize, organise: organizi

original: origina, (not a copy) originala

ornament: ornamaĵo

other: alia

otter: lutro
[edit] OU-

ought: devus

our: nia,

ours: la nia

out: ekstere

out of (from): el

outing: eksterumo

outlander, stranger: alilandulo

outlet (electrical): ŝtop(il)ingo

outstanding: elstara

oven: bakforno, bakuj, forno

oven glove: fornoganto

over: super, pli ol

over here: jen ĉi tie

over there: jen tie

overjoyed: felicxega

owe: ŝuldi

own: posedi, propra

ox: bovo

ox-eyed daisy: lekanto

oxalic: okzala

oxidize: oksidigi, oksidigxi

oxygen: oksigeno

oxygenate: oksigeni

oyster: ostro

oyster bed: ostro(kultur)ejo

ozone: ozono 

pablum: bebokaĉo, kaĉeto

pace: paŝo

pacifier, binkie: suĉumo, suĉilo

pacifism: pacifismo

pacifist: pacifisto

pack, paki,

package: pakaĵo

packet: pako

pad (living space): loĝejo

padding, upholstering: rembur(aĵ)o

page: paĝo

pager: poŝmesaĝilo

paid up, paid-up, even: kvita

pail: sitelo

pain: doloro

painful: dolor(ig)a

paint (a wall, room): farbo, farbi

paint (picture): pentri

pair: paro

pajamas: piĵamo

Pakistan: Pakistano

Pakistani: pakistana, pakistanano

pale: pala

palindrome: spegulvorto

palm (of hand): manplato

pan: kaserolo

pan (frying): pato, fritilo

pancake, flapjack: krespo

Pandora: Pandoro

panel: panelo

panties: kalsono

pantry: (manĝaĵo)ŝranko

pants (trousers): pantalono

pantyhose, tights: kalsonŝtrumpoj, ŝtrumkalsono, ŝtrump(o)pantalono

paper: papero

paper, newspaper: ĵurnalo

paper bag: papersako

paper drive: paperkolektado

(news)paper: ĵurnalo

paper shredder: (papero)pecetigilo

paper towel: (paper)sektuko

parachute: paraŝuto, paraŝuti

Paraclete: Parakleto, Sankta Spirito

parade: paradi, parado

parade float: paradkamiono?

parcel: pako

pardon: pardono, pardon

pardon (me): pardonu

parent: patr(in)o, generinto, gepatro

patental: gepatra

parents: gepatroj

Paris: Parizo

park: parko

parking lot: parkejo

parking meter: parkhorloĝo

parking space, parking spot, parking place: parkloko

parsec: paralakssekundo, parseko

parsley: petroselo

part: parto, (theater) rolo

particular: aparta

party: festo

party (political): partio

party dip: (manĝet)trempaĵo?

pass: pas(ig)i

passport: pasporto

password: pasvorto, salutvorto

past: pasinta, pasinteco, preter

patent: patento, patentita

path: vojo, vojeto

patience: pacienco

patient: pacienca, (medical) paciento

pause: paŭzi, paŭzo

pavement: trotuaro, pavimo

paver: pavinŝtono

paving stone: pavimŝtono

paw: manego

pawn (chess): peono, soldato

pawn: lombardi

pawn broker: lombardisto

pawn shop: lombardejo

pay: pagi, salajro

PDA, palmtop computer: poŝkomputilo
[edit] PE-

pea: pizo

peace: paco, trankvilo

peace loving: pacama

peacock: pavo

peanut butter: ternuksbutero, arakidaĵo

pear: piro

pear tree: pirarbo, pirujo (archaic)

peasant: kamparanto

pedal: pedalo, -i

pedal trash bin: pedalrubujo, pedalsitelo

pee: pisi, -o, urini, -o

pen: plumo, (ball point) globkrajono

pencil: krajono

pencil box: krajonujo

pencil sharpener: krajonakrigilo

peninsula: duoninsulo

penlight: poŝlampeto

penny: penco

people: homoj, popolo, oni

pepper: kapsiko

pepper (chili): kapsiketo

pepper (red): papriko, ruĝa pipro

pepper (spice): pipro, piprumi

pepper spray: sprajkapsikaĵo?

pepper pot: piprujo

perfect: perfekta

perfume: parfumo

perhaps: eble

period: periodo

periodical: gazeto, periodaĵo

peripheral (computer): Flankaparato

permanence: ĉiameco

permanent: konstanta, daŭra

permanent press: negladenda

permission: permeso,

permit: permesi, permesilo

persevere: persisti

Persia: Persujo

Persian: persa, perso

persist: persisti

person: persono

personal computer, PC: persona komputilo, PK

persuade: persvadi

Peru: Peruo

Peruvian: perua, peruano

pervert: fiulo

pestle: pistilo; see mortar

pet (animal): hejmbesto, dorlotbesto

petal: petalo

petit four: biskviteto

petrol (BR), gasoline: benzino

petty: eta, etanima

petty cash: malgrandaj sumoj, monsumetoj?

petty officer: suboficiro

phantom: fantomo

pharmacy (science): farmacio

pharmacy (place): farmaciejo, apoteko

pharmacist: farmaciisto, apotekisto

phenomenon: fenomeno

philatelist: filatelisto

philately: filatelo

philologist: filologo

philology: filologio

philosopher: filozofo

philosophy: filosofio

phone booth: telefonbudo

photo: foto, fotografaĵo

photogenic: fotoplaĉa

photo album: foto-albumo

photograph: foto, fotografaĵo, foti, fotografi
[edit] PI-

piano: piano

pick: elekti

pick up: preni

picnic: pikniko, -o

picture: bildo

picture postcard: bildkarto

picturesque: pitoreska, pentrinda, fotinda

pie: torto, pasteĉo

piece: peco

pigtail (hair): harplekt(aĵ)o

pile: amaso

pillow: kapkuseno

pillowcase: kusensako

pilot light: kontrollamp(et)o

pimple: akno, aknero

pin: pinglo

pin-money: poŝmono

pink: rozkolora

pink eye, conjunctivitis: (kontaĝa) konjunktivito

pinkie, little finger: etfingro, eta fingro

pioneer: pioniro

pipe: tubo, (tobacco) pipo

pirate: pirato

pis: pisi, -o, urini, -o

pitcher: kruĉo

pity: kompati, kompato

pizza: pico

pizzeria, pizza parlor: picejo, picovendejo

PJs, pajamas: piĵamo

place: loko, ejo, meti

place mat: tablotuketo

plait, braid: plekti

plait(hair): harplekt(aĵ)o

plan: plano, plani

plane: aviadilo

plane (tool): rabotilo

plank: tabulo

plant: planto, planti

planter (person): plantisto, plantanto

planter (for plants): plantujo?

plaster (sticking): pretpansaĵo, plastro

plastic: plasto, plasta

plastic wrap: volvoplasto

plate: telero

plate glass: glaco

platform: podio, (station) kajo

platypus: birdbekulo, anasbeka mamulo, ornitorinko

play: ludi, teatraĵo

play house (for kids): luddomo

playground: ludejo, ludkorto

playpen: ludkaĝo

pleasant: agrabla

please: plaĉi (al), mi petas, bonvolu

pleasure: plezuro

plenty: multe (da)

pliers: tenajlo, pinĉilo

plug: ŝtopi

plug (electrical): ŝtopi, ŝtopilo, konektilo, kontaktilo

plug (positive mention of product): reklameto, reklameti

plug up, clog up: ŝtopi

plumber: plumbisto, tubisto

plunge: plonĝ(iĝ)i

pneumatic drill, jack hammer: Pneŭmata martelo
[edit] PO-

P.O. Box: poŝtfako

pocket: poŝo

podcast: podkasto, -i

podium: podio

poem: versaĵo, poemo

poet: versisto, poeto, poemisto

poetry: poezio

point: punkto, pinto, poento

poison: veneno, -i

Poland: Pollando

Pole: polo

pole: stango, poluso

pole saw: stangosegilo

polenta: maiz(o)kaĉo

police: polico

policeman, police woman, police officer: policano, policisto

police station: policejo

policy: politiko

Polish: pola

polish: poluri

polite: ĝentila

politics: politiko

political: politika

pomade, ointment, cream: pomado

ponytail: harvosto, ponevosto

poodle (dog): pudelo

pool noodle: flosstango

poop: feki, -aĵo, kaki (pri bebo), -aĵo

poop deck: ŝipvosto

pooped: laca

poor: malriĉa, kompatinda

pop: krev(iĝ)i, pop(ulara) muziko

popcorn, popping corn: pufmaizo, krevmaizo

popsicle: sukoglaciero

postage, shipping: sendkosto, afranko

popular: populara

population: loĝantaro

porcupine: pikporko, histriko

pork: porkaĵo

porridge: avenkaĉo

port (harbor): haveno

port (ship direction): barbordo, -a

port (opening): apeturo

port (wine): oportvino

portable: portebla

Portugal: Portugalujo, Portugalio

Portuguese: portugala, portugalo

possess: posedi

possible: ebla

possibly: eble

post (mail): poŝto, enpoŝtigi

postage stamp: posxtmarko

postcard: poŝtkarto, bildkarto

pot (cooking): kaldrono

potato: terpomo

potato chips: terpomflokoj, ĉipsoj

potion: eliksiro

potted plant: potplanto, donacplanto?

potty: (pis)poto

potty trained: puruma

pound: (weight) funto, (money) pundo

pour: verŝi

powder: pulvoro

(gun)powder: pulvo

power: potenco

power strip: ŝtopingaro

powerful: potenca

practice (clientele): klientaro

practice (custom, habit): kutimo

practice (exercise): ekzercado

practice (practical action): praktiko

practice (profession): praktikado

practice, practise: praktiki, ekzerci (sin)

prairie dog: prerihundo, cinomuso

praise: laŭdi, laŭdo

praiseworthy: laŭdinda

pram: infanĉareto

pray: preĝi

prayer: preĝo, preĝado

precious: multvalora

precise: preciza

preen: netigi, ordigi

prefer: preferi

preferably: prefere

prepare: prepari (sin)

prepay: antaŭpagi

present: ĉeestanta, donaco, prezenti, donaci

present day: aktuala

presentation: prezento

preserve: gardi, konservi

preside: prezidi

president: prezidanto

press: premi, presmaŝino, gazetaro

pressure cooker: premkuirilo, prempoto

presume: supozi

pretend: ŝajnigi, preteksti

pretzel (soft): breco

prevent: malhelpi

previous: antaŭa

price: prezo

prick: piki, piko

pride: fiero

priest: pastro

primary school (BR): bazlernejo, elementa lernejo

prince: reĝido, reĝinido, princo

princess: reĝidino, reĝinidino, princino

principal: ĉefa, precipa, estro

principle: principo

print: presi

prison: malliberejo, prizono

prisoner: malliberulo

prize: premio

pro tem: provizore

probable: verŝajna, , kredebla, probabla

probably: verŝajne

problem: problemo

proceed: procedi, antaŭeniri

proclivity: emo

profession: profesio

professional: profesia

profound: profunda

prognosis: prognozo

program, programme, programo

progress: progreso, progresi

prohibit: malpermesi

promise: promesi, promeso

prompt: akurata, instigi

prompter: sufloro

prong: dento

pronounce: elparoli, pronunci

proof: pruvo

propel: peli

propane torch: propana torĉo?

property: propraĵo

propose: proponi

prosecuter: persekutisto

protect: protekti

protest: protesti

protestant: protestanto

proud: fiera

prove: pruvi

provide: provizi

provided:(that) kondiĉe (ke)

prudent: prudenta

prune: pritondi, eltranĉi

prune: seka pruno

pruning hook: hoktranĉilo
[edit] PU-

public: publika, (the) la publiko

publicity stunt: reklamfrapo

publish, issue: eldoni

pull: tiri

pullover (sweater): pulovero, pulovro

pump: pumpi, pumpilo

punish: puni

punishment: puno, punado

pupil: lernanto, (eye) pulilo

puppet: (gant) pupo

pure: pura

puree: kaĉo, pureo

purpose: celo

purposely: cele

purse: monujo

push: puŝi

pushchair, stroller: sidĉar(et)o

pushy: puŝema

puss(y) (cat): kat(et)o

pussy (slang): piĉo

put: meti, (on) surmeti

putty knife: spatelo

puzzle: enigmo 

Q (name of letter): kuo

Q-tip, cotton swab: vatbastoneto

quaint: kurioza

quality: kvalito

quantity: kvanto

quarrel: malpaciĝi, kvereli, -o

quarter: kvarono

quarter (of city): kvartalo

quartet: kvaropo


queen: reĝino

queen (chess or cards): damo

queer: stranga

quell: subigi, subpremi

quench: estingi

queue (line of people): viclinio

queue (pigtail): harvosto


quick: rapida

quickly: rapide

quicksand: movsablaĵo

quiet: mallaŭta, silenta

quill-pen: birdplumo

quilt cover: kovrilsako

quintet: kvinopo

quite: tute

Qur'an: Korano 
rabid, mad: rabia

raccoon, racoon: lavurso, prociono

raccoon dog: procionhundo, niktereŭto

race: raso, vetkuri, vetkurado

radar: radaro

radiator: radiatoro

radical: radikala

radio: radio, radiofono, radioricevilo

rag: ĉifono

railfan: fervojavidulo, fervojfotisto

railroad: fervojo

railroad crossing: fervoja transirejo, reltransirejo

railroad modeling: skalfervojado?

railway: fervojo, fervoja

rain: pluvo; (it's raining) pluvas

rainbow: ĉielarko

raincoat: pluvmantelo

raindrop: pluvero

rapid: rapida

raisin: sekvinbero, rosino

raspberry (fruit): frambo

rat: rato

rat poison: musveneno, ratveneno

rat trap: ratkaptilo

rather: iom

rather: plivole, prefere

ray: radio

razor: razilo
[edit] RE-

reach: atingi

read: legi

read aloud: laŭtlegi

ready: preta

real: vera, efektiva

really: vere, efektive

really and truly: ververe

realm: regno

reap: rikolti

rear: malantaŭo, malantaŭa

rear (hinder part): postaĵo, posta parto

reason: kialo

reasonable: prudenta, racia

recall, recollect: rememori

receipt: kvitanco, ricevo

receive: ricevi

receiver (of telephone): aŭskultilo

receptacle: ujo

receptacle (electrical): (elektra)ŝtopilingo

reception room: salono

recipe: recepto

reciprocal: reciproka

recline: kliniĝi, kuŝi

recognize, recognise: rekoni

recommend: rekomendi

reconcile: repacigi, akordigi

record: registri, registro, disko

record (best performance): rekordo

recorder (take, cassette): magnetofono

red: ruĝa

red letter day: festa tago

refer: rilati

reflect: reflekti, speguli

refrigerator: fridujo, glaciŝranko

refrigerator car (or van), reefer: frostvagono

refuse: rifuzi

refusal: rifuzo

regard: rigardi, rilato

regarding: rilate al

region: regiono

register: registri, registrolibro

regret: bedaŭri, bedaŭro

regular: (laŭ regula)

rejoice: ĝoji

relate: rilati, rakonti

relation: rilato, (relative) parenco

relative: parenco, relativa, rilata

relax: malstreĉ(iĝ)i

religion: religio

relish tray: fakpleto

remain: resti

remainder: resto, cetero, restaĵo

remark: komenti, komento

remember: memori

reminiscence: memoraĵo

reminiscent: primemora

remote: malproksim(eg)a, fora

remote control: (televidila)regilo, sendrata regilo

rend: ŝir(iĝ)i

repair: ripari, riparo

repeat: ripeti, ripeto

reply: respondi, respondo

report: raporti, raporto

reporter: raportisto

repose: ripozi, ripozo

represent: reprezenti

reproach: riproĉi, riproĉo

reptile: reptilio, rampulo

reptilian: reptilia, reptileca

republic: respubliko

request: peti, peto

require: postuli, bezoni

rescue: savi, savo

research: esplori, esplor(ad)o

resemble: simili

reserve: rezervi

resist: rezisti

resource (ingenuity): eltrovemo

resource (means): rimedo

resourceful: rimedoplena, eltrovema

resources (money): monrimedoj

resources (provision): provizo

respect: respekti, respekto

respond: respondi

response: respondo

rest: ripozi, ripozo

rest stop, rest area: veturpaŭzejo

restaurant: restoracio

result: rezulto, rezulti

return (come back): reveni, reveno

return (go back): reiri, reiro

return (give back): redoni, redono

revenge: venĝo

reverend: pastro

review, revue: revuo, (criticize) recenzi, -o

revolution: turno,

revolution (political): revolucio
[edit] RI-

rice: rizo

rich: riĉa

ride: (horse, cycle) rajdi, (in vehicle) veturi, veturo

rig (a ship): rigi

rig (dress): vesto

rig (of a ship): rigo

rig out: vesti

rig up: starigi

rigging: rigilaro

right (make right again): rebonigi

right (set upright): restarigi

right (good): bono

right (justice): justo

right (just claim): rajto

right (accurate): ĝusta

right (fitting, suitable): taŭga

right (in good order): en ordo

right (in opinion or action): prava

right (just): justa

right (not left): dekstra

right (entirely): plene, tute

right (really): vere

right (straight): rekte

right (well): bone

right angle: orta angulo, orto

right angled: orta

right on!: ĝuste!, konsentite!

righteous (just): justa

righteous (virtuous): virta

rightful: rajta

rigid: rigida

rim: rando

ring: ringo rondo, sonor(ig)i

ring finger: ring(o)fingro

ringworm: favo

rinse: gargari

rip: ŝir(iĝ)i

ripe: matura

ripen: maturiĝi

ripple: ondeti, -o, ringondeti?, -o?

rippling: ondeta

risk: risko, riski

river: rivero
[edit] RO-

road: vojo

roadway: voj(eg)o, aŭtovojo, ŝoseo

road rage: vojkolero

roam: vagi

roast: rosti, rostaĵo, rostita

rob: ŝteli, rabi

robber: rabisto

robe: robo

robot: roboto

rock: roko, -a

rock garden: rokĝardeno

rock music: rokmuziko

rocking chair: lulseĝo

rogue: fripono

role: rolo

roll: rul(iĝ)i

roll (pass a roller over): rulumi

roll (wrap): volv(iĝ)i

roll (material rolled up): rulo

roll (bread): bulko

roll (of drums): rulsono

roll (register): registro

rolling pin: rulknedilo, rulpremilo

roly-poly: ruliĝulo

Romanche, Romansch (Swiss dialect): romanĉa

Romania: Rumanujo, Rumanio

Romanian: rumana, rumano

roof: tegmento, -i

roof (of mouth): palato

room (chamber): ĉambro

room (place, space): loko, spaco

room (small private, e.g. study, consulting room): kabineto

rooms (apartments): apartamento

roomy: spaca

roomy (cohabitee): samĉambrano

rooster: (vir)koko

root: radiko

rope: ŝnuro

rose: rozo

rotary: turniĝa, rotacia

rotate: turn(iĝ)i, rotac(ig)i

rotisserie: turnrostilo, stangorostilo

rototiller: (rotacia)kultivmaŝino

rotten: aĉa, putra

rough (surfaced): malglata

round: rondo, ronda, ĉirkaŭ

rouse: veki, instigi

route: vojo

row: remi

row (line): vico

royal: reĝa
[edit] RU-

rub: froti

rubbish: rubo, sensencaĵo

rubble: rubo

rug: tapiŝo

rugby: rugbero

rule: regulo, regi, regado

ruler: liniilo, mezurilo, reganto

rum: rumo

run: kuri, flui, funkcii

runny nose: mukema nazo

rusk: biskoto

Russia: Rusujo, Rusio

Russian: rusa, ruso

rust: rusto

rust (color): rustkolora

rusty: rusta 

sabbath: sabato

saber: sabro

sack: sako

sacred: sankta

sacrifice: oferi, oferaĵo

sad: malgaja, malĝoja, trista

sadden: malĝojigi, aflikti

safe: sendanĝera, sekura

safety: sendanĝereco, sekureco

sage: saĝa, saĝulo

sage (plant): salvio

sail: velo, veladi, ekvojaĝi

sailor: maristo

saint: sanktulo

Saint Paul: Sankta Paŭlo

salad: salato

salami: salamo

salary: salajro

saliva, spittle: salivo

salon: salono

salt: salo

salt shaker: salujo

same: sama, samo

sand: sablo, -i

sand (a piece of wood): sablumi?

sand box: sablujo, sablokesto

sand mold: sabloformujo, sabloformilo, sablomuldilo

sanitary napkin: menstrutuko

sanitary protection: menstrusorbilo

sanitary towel (BR): menstrutuko

Santa Claus: Avo Frosto

sarcasm: sarkasmo

sarcastic: sarkasma

sardonic: mokmalica

satiated: sata

satisfy: kontentigi

satisfied: kontenta

Saturday: sabato

saucepan: kaserolo, kuirpoto

saucer: subtaso

save: (rescue) savi, (economize) ŝpari

saw: segi, segilo

saw dust: segpolvo

sawmill: segejo

sawpit: segfoso, segputo

say: diri

scab (on wound): krusto

scabbard: glavingo

scale(s): pesilo

scanner (computer): skanilo

scarcely: apenaŭ

scare: timigi

scarf: skarpo

scene: sceno, vidaĵo

scenery: pejzaĝo

school: lernejo

science: scienco

scientist: sciencisto

scissor(s): tondilo

scold: mallaŭdi, riproĉi

scorpion: skorpio

Scot: skoto

Scotland: Skotlando

Scottish: skota

scout: skolto

scout (boy scout): skolto

scout (cub scout): lupido

scout (girl guide): skoltino

scoutleader, scoutmaster: skoltestro

scrapbook (album): albumo

scrapbooking: albumumado?

scrape: skrapi

screen: ekrano

screen color: malfono

screwdriver: ŝraŭb(turn)ilo

sculpt: skulpti

sculptor: skulptisto

sculpture: skulptaĵo

scythe: falĉilo
[edit] SE- 

sea: maro

seal: marhundo, foko

seashore: marbordo

seamstress: kudristino

search: serĉi, serĉo, priserĉi

search engine: (ret)serĉilo

season: sezono, spici

seat: seĝo, benko, sidloko (on bus, in theater, etc.)

second (time) sekundo

second: dua

second hand smoke: pasiva fumado

secret: sekreto, sekreta

secretary: sekretari(in)o

secure: sekura, sekurigi

security: sekureco

see: vidi

see ya!: ĝis la!

seeing eye dog: gvidhundo

seek: serĉi, (try) peni

seem: ŝajni

seesaw: baskulo, balancilo

seethe (cook): boli

seethe (swarm):svarmi

segway (transport): starveturilo

sell: vend(iĝ)i

send: sendi

Senegal: Senegalio

Senegalese: senegala, senagalano

sense: (meaning senco, (common sense) prudento

sensible: prudenta, inteligenta

sentence: frazo

separate: aparta, apartigi

September: septembro

series: serio

serious: serioza, grava

serpent: serpento

serve: servi

service: servo, servado

service (religious): Diservo

service dog: gvidhundo

serving cart: servoĉar(et)o

serving trolly: servoĉar(et)o

set: aro, kompleto, (radio.TV) aparato

setting: loko; fono; agordo; kadro; muzikaranĝo

seven: sep

several: pluraj, kelkaj

severe: severa

sew: kudri

sewing basket: kudrilarkorbo

sewing box: kudrilarujo, kudrilarkesto

sewing class: kudrokurso

sewing machine: kudromaŝino

sewing things: kudrilaro

sewing thread: kudrofadeno

shade, shadow: ombro

shade tree: ombroarbo

shake: skui

shake hands: manpremi

shakedown: ĉantaĝo; serĉado; alkutimiĝa periodo; fina provado

shakeup: granda reordigo

shallot: ŝaloto

shame: honto, (be ashamed) honti

shape: formo

share (divide): (kun)dividi

share (partake in): partopreni (en)

share (financial): akcio

share (part): parto

share (portion): porcio

share out: porciigi, disdividi

shareholder: akciulo

sharp: akra

sharpen: akrigi

shave: razi (sin)

shaver: razilo

she: ŝi

sheep: ŝafo(j)

sheet: folio

sheet (bed): lit(o)tuko

sheet-metal: lado

shelf: breto

shelves (set): bretaro

shepherd: ŝafisto

shield (protection): ŝirmilo

shine: brili

ship: ŝipo

shipping, postage: sendkosto, afranko

shipshape: bonorda

shirt: ĉemizo, (woman's) bluzo

shirtless: senĉemiza

shish kebab: (pecigita) pikilrostaĵo

shiver: (frosto)tremi

shoe: ŝuo

shoe string, shoe lace: ŝulaĉo

shoot: pafi

shop: vendejo, butiko, magazeno, butikumi

shop-lift: butikŝteli

shop-lifter: butikŝtelisto

shop-lifting: butikŝtelado

shopping bag: aĉetsako

shopping basket (wheeled): rulsako

shopping cart: aĉetĉaret, aĉet-rulkorbo, rulsako, rulkorbo

shopping center: vendejcentro

shopping mall: vendejaro

shore: (mar)bordo

short: mallonga

short cut: ŝparvojo

should: -us, devus

shoulder: ŝultro

shout: krii, kriegi

show: montri, spektaklo, programo

shower: duŝi (sin), duŝejo

shower: pluveto

shower (party): donacfesto

showy: pava

shredder (for paper): (papero)pecetigilo

shut: ferm(iĝ)i

shy: timema
[edit] SI-

sibling: samgepatrido, frat(in)o, gefrato

side: flanko, flanka

sideboard: telermeblo

sieve: kribrilo

sign: signo, subskribi

signature: subskribo

signal: signalo

signify: signifi

silence: silento, (be silent) silenti

silhouette: silueto

silk: silko, silka

sill: fenestrobreto

silly: komika, stulta, malsprita, idiota

silo: silo

silver: arĝento, arĝenta

simple: simpla

sin: peko, peki

since: de, ekde, ĉar

sincere: sincera

sincerely: sincere

sing: kanti

sink (kitchen): lavujo

sir: sinjoro

sister: fratino

sister-in-law: bofratino

sit: sid(iĝ)i, eksidi

site: loko, situo

sitting room: salono

situation: situacio, situo

sitzbath: sidbano

six: ses

sixth: sesa

size: grando, grandeco

skateboard: rultabulo

sketch: (theater) skeĉo

skewer: (viand)pinglo

ski: skii, skio

skill: lerteco

skillful: lerta

skin lotion, skin cream: haŭtkremo

skip rope, jump rope: ŝnursalti

skipper (head of ship): ŝipestro

skirt: jupo

skunk: mefito

sky: ĉielo

skype: skajpi

skyscraper: nubskrapulo, ĉielskrapanto

slack: malstreĉita

Slav: slava, slavo

slat: lato

sleep: dormi

slender: maldika, svelta

slice: tranĉi, tranĉ(aj)o

slide: glit(ig)i

slide (act of sliding): glito

slide (place for sliding): glitejo

slide (in a camera): kaseto

slidingboard: (lud)glitejo

slim: maldika

slip: gliti

slop: verŝaĉi

sloppy dildop: fuŝverŝulo

Slovak: slovaka, slovako

slow: malrapida, (clock) malfrua

slug: limako

slurp (act): suĉtrinki

slurp (sound): suĉsono

small: malgranda, eta

smell: odoro, odori

smell (something): flari

smolder: subbruli

smile: rideti, rideto

smoke: fumi, fumo

smoke (cigarette): fumi

smoke detector: fumdetektilo

smoked glass: fum(o)vitro

smokescreen: fumnebulo; vualo, preteksto

smooth: glata, glatigi

snack: manĝeto

snack bar: manĝetejo

snail: heliko

snake: serpento

snake (around): serpentumi

snap: fingroklaki

sneakers: tolŝuoj, kurŝuoj

sneeze: terni, -o

snore: ronki

snot, mucus: muko

snow: neĝo, neĝi

snow man: neĝhomo

snow tire: neĝpneŭo

snowball: neĝbulo

snowflake: neĝero

snowshoe: neĝŝuo
[edit] SO-

so: tiel, (therefore) do

so that: por ke

soap: sapo

soccer: futbalo

soccer ball: (futbal)pilko

social: socia, sociala, distra vespero

socialism: socialismo

socialist: socialisto, socialisma

socialize: amikumi

society (general): socio, (association) societo

sock: ŝtrumpeto

sock (hit): frapi, frapo

socket: ingo

socket wrench: boltingilo

sofa: kanapo

soft: mola, dolĉa

soft (not loud): mallaŭta

softly: mallaŭte

software: programaro, softvaro

soil: grundo

soldier: soldato, militisto

sole: sola

solemn: solena, serioza

solve: solvi

solution: solvo

some: iu(j), iom da, kelkaj

some kind of: ia(j)

somebody, someone: iu

somebody's, someone's: ies

some how: iel

something: io

sometimes: foje, kelkfoje

somewhat: iom

somewhere: ie(n)

son: filo

son-in-law: bofilo

song: kant(aĵ)o, kanzono

soon: baldaŭ

sorry: (to be sorry) bedaŭri

sort: speco

soul: animo

sound (give out a sound): soni

sound (resound or cause to resound): sonor(ig)i

sound (plumb): sondi

sound (seem): ŝajni

sound (noise): sono

sound (straits): markolo

sound: solida

sound (asleep): profunda, -e

sound (without defect): sendifekta)

sound system: sonaparato

soup: supo

soup plate: suptelero

sour: acida

sour cream: acidkremo

source: fonto

south: sudo

southern: suda

South Africa: Sudafriko

South African: sudafrika, sudafrikano

Soviet: soveto, soveta

Soviet Union: Sovetunio

sow (female pig): porkino

sow (plant seeds): semi

soy sauce: sojo

soy milk: sojlakto, soja lakto

space (between objects): spaco

space (outer): kosmo

space settlement: kosma urbo, urboŝipo

space shuttle: (kosmo)pramo

spacecraft: kosma aparato

spaceflight: kosma flugo

spaceport: kosmohaveno

spaceship: kosmoŝipo

spacesuit: skafandro

spacious: vasta

spade: fosilo

spaghetti: spagetoj

Spain: Hispanujo, Hispanio

Spaniard: hispano

Spanish: hispana

spare tire: krompneŭo, vicpneŭo

spatula: spatelo

speak: paroli

speaker, loudspeaker: laŭtparolilo

spear: lanco, -i

spearhead: lancpinto

spearmint: verda mento

special: speciala

specialist: specialisto, fakulo, -a

specialty: specialaĵo

speciality: fako

specialize: fakumi?

specimen: specimeno

spectacle: spektaklo

spectacles: okulvitroj, oklo (proposed word)

spectator: spektanto

speech: parolado

speed: rapid(ec)o

speed bump: (rapidlimiga) vojĝibo

spend: (money) elspezi, (time) pasigi, (the night) tranokti

spice: spico

spider: araneo

spider web: araneaĵo

spiffing: oĵa (proposed word)

spill: fuŝverŝi, misverŝi

spin: (rapide)rotacii

spin-dry: centrifugi

spin-dryer: centrifuga sekigilo

spinach: spinaco

spine: spino

spirit: spirito

spit: kraĉi, -o

spit up, regurgitate: vometi

spite: malico

(in) spite (of): malgraŭ

splendid: belega, grandioza, oĵa (proposed word)

splendid!: bonega!

split: fend(iĝ)i

spoil: difekt(iĝ)i

spoon: kulero

spoon rest: kulerumo?

sporadic: sporada

sport: sporto

sport drink: sporttrinkaĵo?

sportsman: sportisto

sports Utility Vehicle, SUV: aŭtego

spot: makulo, loko, punkto

spot: ekvidi

spot: lokigi

spouse: edz(in)o

spray: ŝpruci, -o

spray starch: ŝprucamelo

sprayer (on iron): ŝprucigilo

spread: etend(iĝ)i, disvastigi, disvastiĝi

spring (season): printempo, (source) fonto

spring (mech): risorto

sprocket: dent(o)rado

spy: spiono, -i, kaŝobservi

square: kvadrato, (town) placo

squash: kukurbo

squeamish: maŭzema, naŭzemulo

stack: staki, -o

stage: scenejo

stain: makuli, makulo

stair: ŝtupo

staircase: ŝtuparo

stake: paliso

stale: malfreŝa

stamp: stampi, stampilo, (post) poŝtmarko

stand: stari

stand out: elstari

stand up: stariĝi, ekstari

standard: nivelo, grado, (flag) standardo

star: stelo

starboard (ship direction): tribordo, -a

starch: amelo, -i

start: komenc(iĝ)i

state: (condition) stato, (polit.) ŝtato

station: stacio, stacidomo

statue: statuo

stay: resti

stay-at-home-dad: dommastra patro, ĉehejma paĉjo

steal: ŝteli

steam: vaporo

steam bath: vaporbano

steam iron: vaporgladilo

steamship: vaporŝipo

stench: odoraĉo, fetoro

step: ŝtupo, paŝo, paŝi

step father: stifa patro, stipatro?

step mother: stifa patrino, stipatrino?

stereo, stereophonic: stereofonia, sterea, stereo-

stern (of ship): ŝipvosto

stew (boil gently): bolet(ig)i

stew (fruit): kompotigi

stew (meat): stufi, stufaĵo

steward: stevardo

stewardess: stevardino

stick: bastono, glu(iĝ)i

stick bug: promenanta branĉo

sticker: glumarko

sticking plaster: pretpansaĵo, plastro

stick insect (BR, AU): promenanta branĉo

stiff: rigida

still: senmova, ankoraŭ

still life: muta naturo, senviva sceno

stimulate: stimuli

stimulus: stimulo

sting: piki, piko

stir: kirli

stitch: kudrero

stock: provizo, stoko, stoki

stocking: ŝtrumpo

stomach: stomako

stone: ŝtono, -a

stoop: kliniĝi, -o

stoop: (sentegmenta) antaŭpordo

stop: halt(ig)i, ĉes(ig)i, punkto

stopper, bung: ŝtopilo

store: magazeno, butiko

store-cupboard (BR): manĝaĵoŝranko

story, storey: etaĝo

story: rakonto, historio

stout: dika

stove: kuirforno, fornel, forno, hejt(o)forno

stowaway: kaŝvojaĝanto

straight: rekta, rekte, malkurba

straighten: rektigi, malkurbigi, rektiĝi, malkurbiĝi

strange: fremda, nekonata, stranga

straw: pajlo, (one straw) pajlero

straw (drinking) ŝalmo, trinktubeto

street: strato

stress: akcenti

stress (accent): akcento

stress (emphasis): emfazo

stress (pressure): premo

stressed out: trostreĉita

strew: disŝuti

strict: severa

stride: paŝ(eg)o, paŝ(eg)i

strike: frapi, bati, striki

striking (appearance): okulfrapa

string: ŝnureto

string trimmer: ŝnurtondilo

strip: strio, senvest(iĝ/ig)i

stripe: strio

stroller: infanĉar(et)o, beboĉar(et)o

strive: peni

stroller, pushchair: sidĉar(et)o

strong: forta

struggle: lukti, lukto

student: studanto, studento

study: studi, studado, esplori, esploro

stuffed animal: pluŝbesto

stuffing (turkey, goose, etc.): farĉo

stunt: nanigi

stunt (advertising): reklamfrapo

stunted: nana, nanigita
[edit] SU-

subject: temo, subjekto, studobjekto

subject (school): fako

submarine: submarŝipo, submarilo

subscribe: aboni

substance: aĵo

subtle: subtila

succeed: sukcesi

success: sukceso

such: tia

suck: suĉi

Sudan: Sudano

Sudanese: sudana, sudanano

sudden: subita

suffer: suferi

suffice: sufiĉi

sufficient: sufiĉe da

sugar: sukero

sugar bowl: sukerujo

suggest: sugesti

suicide: sinmortigo

suicide (commit): (mem)mortigi sin

suit: konveni, taŭgi (al)

suit: kompleto, (woman's) tajlorkostumo

suit (cards): emblemo, svatado, proceso

suitable: konvena, taŭga

sultana: sultana sekninbero, sultanrosino

sum: sumo

summarize: resumi

summary: resumo

summer: somero

summit: pinto, supro

summon: alvoki

sun: suno

sunbathe: sunbani

Sunday: dimanĉo

sunglasses, shades: sunvitroj

sunrise: sunleviĝo, tagiĝo

sunscreen: sunkremo

sunset: sunsubiro

sunshade: sunombrelo

sunshine: sunbrilo

sunspot: sunmakulo

sunstroke: sunfrapo

suntan lotion: sunkremo

super-: super-

super: bonega, figuranto

super hero: superheroo

superior: supera

supper: vespermanĝo

supply: provizi

support, sustain, lean: apogi

suppose: supozi

supra-: super-

sure: certa

surely: certe

super!: bonege!

super-: super-

superb: bonega

superconductivity: superkonduktivo

superhighway: aŭtovoj(eg), ŝoseo

superman: superhomo

supermarket: memserva vendejo, manĝaĵovendejego

supernova: supernovstelo

supersonic: supersona

supper: vespermanĝo

suppose: supozi

supra-: super-

surface: supraĵo

surgeon: kirurgo, ĥirurgo

surprise: surprizi, surprizo

surround: ĉirkaŭi

surroundings: ĉirkaŭaĵo

sushi: suŝio

sushi bar: suŝiejo

suspect: suspekti,

suspension-bridge: pendponto

suspicion: suspekto

sustain, support, lean: apogi

SUV, sports utility vehicle: aŭtego

swallow: (en)gluti

swallow (bird): hirundo

swallow-tail (butterfly): makaono

swan: cigno

sweatjacket: ŝvitjako

sweatshirt: ŝvitĉemizo

Sweden: Svedujo, Svedlando, Svedio

Swede: svedo

Swedish: sveda

sweep: balai

sweet: dolĉa, dolĉaĵo

sweet pepper: dolĉakapsiko

sweets: bombonoj

swelling, bump: ŝvel(aĵ)o

swim: naĝi

swimming noodle: flosstango?, naĝarko?

swimsuit: naĝvesto

swing (rock, oscilate): balanc(iĝ)i

swing (turn on an axis): turn(iĝ)i

swing (swing freely): svingi(ĝ)i

swing (instrument for swinging): balancilo, svingilo

swing (rocking, oscilation): balanciĝo

swing (swinging): svingo

swing (with a swing): svinge

swing-bridge: turnponto

swing gate: turnpordo

swing (child's): (lud)svingilo

Swiss: svisa, sviso

switch: (on) ŝalti, (off) malŝalti

switchback: ondanta fervojo

Switzerland: Svislando

swoop: flugfalo, flugfali

sword: glavo

symphony: simfonio

Syria: Sirio

Syrian: siria, siriano

syrup: siropo 

t’ai chi: tajĝio

T-shirt: t-ĉemizo (to-ĉemizo)

table: tablo, (list) tabelo

tadpole: ranido

taekwondo: tekvondo

tag (game): tuŝludo

tail: vosto

take: (pickup) preni, (carry) porti

talent: talento

talented: talenta

talk: paroli, parolado

talk to oneself: sinparoli

tall: alta, altkreska

tampon: (menstru)tampono

Tanzania: Tanzanio

Tanzanian: tanzania, tanzaniano

tap water: kranakvo

tape: bendo

tape recorder: magnetofono

tapestry: tapeto

task: tasko

taste: gusto, (have flavor) gusti, (with tongue) gustumi

Tater-Tot (hash brown): terpombuleto, terpomaĵo?

taxi: taksio

tchotchke: bagatelaĵo
[edit] TE-

tea: teo, temanĝo (BR), kolaziono

teabag: tesako

tea cozy, teacosy: tekruĉomufo

tea mix (iced tea mix): tepulvoro

teacup: tetaso

teapot: tekruĉo

tea set: teservico

teach: instrui

teacher: instruist(in)o

team: ludantaro, teamo

tear: ŝiri, -iĝi

tear(drop): larmo

tear gas: larmiga gaso

teaspoon: tekulereto, longtenila kuler(et)o

teatime (BR): tehoro

technique: tekniko

technology: teknologio

teddy bear: pluŝurso

telephone: telefono, -i (al)

telephone booth: telefonbudo

teleprompter: suflorilo?

television: televido, (set) televidilo

television series: dramserio

tell: diri al, informi

temper: humoro, koleremo

temperature: temperaturo

temporarily: dumtempe

temporate: mezvarma

ten: dek

tend (have a tendancy): tendenci, emi

tend (take care of): prizorgi

tender: dolĉa

tennis: teniso

tent: tendo

termite: blanka formiko, termito

terra incognita: tero nekonata

terrible: terura

terror: teruro

terrorism: terrorismo

terrorist: terroristo

testify: atesti

text: (SoMoSo) 

textile: teksaĵo

Thames: Tamizo

than: ol

thank: danki

thanks!: dankon!

that: ke, tio, tiu (rel. pronoun) kiu

thaw, thaw out, melt: degeli

thaw (spring): degel(veter)o

the: la

thee: ci (archaic, not used)

theater, theatre: teatro

their: ilia

them: ili, ilin

theme: temo

then (at that time): tiam, (next) poste

theory: teorio

theoretical: teoria

there: tie(n)

therefore: tial

they: ili

thick: dika, densa

thief: ŝtelisto

thimble: fingringo

thin: maldika, maldensa

thing: objekto, aĵo, afero

thingamajig: umaĵo

think: pensi, kredi, opimii

Thinking Day: Interpensa Tago

thirst: soifo, soifi,

thirsty: soifa

this: ĉi tiu, ĉi tio

thou: vi

though: kvankam, tamen

(as) though: kvazaŭ

thought: penso

thoughtful: pensema

thousand: mil

thread: fadeno

threat: minaco

threaten: minaci

three: tri

throat: gorĝo

through: tra, (because of) pro

throw: ĵeti

thumb: dikfingro, polesko

thunder storm: fulmotondro(ŝtormo)

Thursday: ĵaŭdo
[edit] TI-

tic tac toe (game): tri en vico

tick: suĉakaro, iksodo

ticket: bileto

tiger: tigro

tigress: tigrino

tight: streĉita, strikta

tighten: streĉi

tights, pantyhose: kalsonŝtrumpoj, ŝtrumkalsono, ŝtrump(o)pantalono

tile (roofing): tegolo, -i

tile (floor, wall): kahelo, -i

tile (flat brick): platbriko

till: ĝis, (shop) kaso

till: kaso

till: kulturi

tiller (rototiller): (rotacia)kultivmaŝino, kultivilo

tilt: klin(iĝ)i

timber: ligno

time: tempo

time (of day): horo

time (occasion): fojo

(on) time: ĝustatempe

(what) time (is it?): kioma horo (estas)?

tin: (box) skatolo

tinfoil: stanfolio, staniolo

tiny: eta

tip: pinto, (gratuity) trinkmono

tire: lac(iĝ/ig)i

tire, tyre (BR): pneŭo, pneŭmatiko

tire chain: pneŭ(o)ĉeno

tire pump: pneŭaŝvelilo, pneŭapumpilo

tire tool, tire iron: pneŭ(o)levilo

tire valve: pneŭvalvo

tired: laca

title: titolo

titmouse: paruo
[edit] TO-

to: al, ĝis, (in order to) por

toast: rostpano, (drink) tosti, tosto

toaster: panrostilo

toaster pastry (pop tart): plattorteto

tobacco: tobako

today: hodiaŭ

toe: piedfingro, pingro (proposed by me, but I'm not holding my breath)

tofu, soy bean curd: sojkazeo, tofuo, tohuo

toilet, WC: necesejo

toilet paper, toilet roll: neceseja papero

toilet seat, toilet bowl: neceseja seĝo

toilet trained: puruma

tolerate: toleri

tomato: tomato

tomcat: virkato

tomorrow: morgaŭ

tongue-in-cheek: ŝercema

tonight: hodiaŭ vespere, hodiaŭ nokte, ĉi nokte

too: (much) tro, (also) ankaŭ

tool: ilo, laborilo

toolbox: ilarujo, ilarkesto

tooth: dento

toothache: dent(o)doloro

toothbrush: dent(o)broso

toothpaste: dent(o)pasto

toothpick: dent(o)pikilo

top: supro, pinto, supra, ĉefa

top, catch, cap, cover, stopper, lid, fastener: fermilo

topic: temo

topical: aktuala

torch: torĉo, poŝlampo

tortoise: testudo

total: sumo, tuto

totem: totemo

touch: tuŝi

tour: rondvojaĝo, rondvojaĝi

tourism: turismo

tourist: turisto

towards: al, en la direkto al

towel: mantuko, bantuko

tower: turo

town: urbo

toy: ludilo

toybox: ludilujo, ludilkesto

track: vojo, (fervoj)trako, spuro, spuri

trade: komerci, komerco

trade (swap): interdoni?

tradition: tradicio

traditional: tradicia

traffic: trafiko

traffic light: (BR) trafiklumo

train: vagonaro, trajno

train: (athlete) trejni, (animal) dresi

train of thought: pensumado

tranquil: trankvila

translate: traduki

travel: vojaĝi, vojaĝado

tray: pleto

treat: trakti, (med) kuraci

tree: arbo

tremble: tremi

tricycle, tri-cycle: triciklo, trirada biciklo, trirada velocipedo

trilingual: trilingva

trip: ekskurso

trip: stumbli

tripe: tripo

tripod, trivet: tripiedo

trivet: izolplato, izolmato, izolumo

trousers: pantalono

truck: ŝarĝaŭto, kamiono

truck stop: kamionhaveno

true: vera

truly: vere

really and truly: ververe

trunk: kofro

trunk (body, tree): trunko

trust: fido, fidi (al)

truth: ver(ec)o, veraĵo

truthful: verdira

try: peni

try out: provi
[edit] TU-

tub: kuvo

tubeless tire: sentuba pneŭo

Tuesday: mardo

tumble: fali

tumble dryer: agita sekigilo

tune: melodio, ario

tuning fork: tonforko

Turk: turko

Turkey: Turkujo, Turkio

turkey: meleagro

turkey meat: meleagraĵo

Turkish: turka

turn: turn(iĝ)i

twain: du

tweezer(s): pinĉil(et)o

twin: ĝemelo, ĝemela

two: du

two-faced: duvizaĝa

type: speco, (with typewriter) tajpi

typewriter: skribmaŝino 
udder: (bov)mamo

UFO (unidentified flying object): NIFO (neidentigita fluganta objekto)

ugly: malbela

ukulele: ukulelo

ulcer: ulcero

ultrasonic: ultrasona

untra-violet: ultraviolo, -a

umbrella stroller: faldĉar(et)o

umpteen: dek um

umpteenth: dek uma

unanimous: unuanima

uncle: onklo

under: sub

underbrush: arbetaĵoj

underhanded (dishonestly): kaŝe, inside, malhoneste

underneath: sub, sube

underpants: kalsono

undershirt: subĉemizo

understand: kompreni

undertake: entrepreni

undertow: subrefluo

underwear: subvestoj

be unfaithful, be unfaithful to, cuckold: kokri

unfortunately: bedaŭrinde

unhappy: malfeliĉa

unhappiness: malfeliĉeco

uniform resource locator (URL): uniforma rimeda lokindiko (URL)

union: unuiĝo

unique: unika

unite: unuiĝi

United States: Usono

universal: universala

universe: universo

university: universitato

unknown: nekonata, nesciata

unless: se...ne, krom se

unlock: malŝlosi

unlocked: malŝlosita, malŝlosis

until: ĝis

unworthy: malinda

up: supre(n)

up to: ĝis

up to (but not across): maltrans

upholstering, padding: rembur(aĵ)o

upon: sur

upstairs: supre(n)

urban: urba

urchin (child): bubo

urchin (sea): ekino

urge: instigi

urgent: urĝa

URL (uniform resource locator): URL (unuforma rimeda lokindiko)

Uruguay: Uragvajo

Uruguayan: Uragvaja, Uragvajano

us: ni, nin

USB flash drive: USB-poŝmemorilo, memorstango

use: uzi, uzo, utilo

use up: eluzi

useful: utila

useless: senutila

usual: kutima

utensil: ilo, ujo 

vacation: libertagoj, ferioj

vacuum (clean): polvosuĉi, suĉilumi?

vacuum cleaner: (polvo)suĉilo

vain (conceited): (mem)fiera

vain (futile): vana

vain (trivial): vanta

vainglorious: fanfarona

vainglory: fanfaronemo

valance: pendbordero

vale: valo

valiant: brava

valley: valo

value: valoro

valuable: valora

valve stem (on tire): valvtigo, pneŭvalvo

vane: ventmontrilo

vanilla: vanilo, -a

variety: diverseco, (theater) varieteo

various: diversaj

vase: vazo

vast: vast(eg)a

vat: kuvo
[edit] VE

veal: bovidaĵo

vegetable: vegetaĵa, vegetala

vegetarian: vegetara

vehicle: veturilo

veil: vuali

veil: vualo

veiling (fabric): vualŝtofo

velcro fastener: lapo, lapfermilo

Venetian blind: ĵaluzio

Venezuela: Venezuelo

Venezuelan: venezuela, venezuelano

vengeance: venĝo

ventilate: ventoli

ventilation: ventolado

ventilator, fan: ventolilo

vertical: vertikala

very: tre

vessel, container: ujo, vazo

vessel (craft): ŝipo

vest, waistcoat (BR): veŝto

vest (BR): subĉemizo

vestibule: antaŭĉambro, vestibulo

veto: maljesi, -o
[edit] VI

vice: malvirto

Vice President: vicprezidanto

victory: venko

video cassette recorder, VCR: vidbendaparato, videoaparato

video game console: ludkonzolo

videotape: vidbendo

view finder: celilo

village: vilaĝo

violence (great force): fortego

violence (unjustifiable force): perforto

violent: fortega

violin: violono

virtue: virto

vinegar: vinagro

vise: vajco

visible: videbla

visit: viziti

visitor: vizitanto

vixen (female fox): vulpino

vixen (spiteful woman): maliculino

vixenish: maliculina

viz.: nome
[edit] VO

vocabulary: vortlisto, vortaro

vogue: modo

voice: voĉigi

voice: voĉo

voiceless: senvoĉa

void: malplenaĵo

void (empty): malplena

void (null, invalid): nula

void of (devoid of): (tute) sen

voidable: nuligebla

volume (book): volumo

volume control: laŭtigilo, laŭtregilo

vote: voĉdoni

vote: voĉ(don)o

vote (right to vote): voĉrajto

vote (voting): voĉdono

voting booth: voĉdonbudo

voting place: voĉdonejo

voyage: vojaĝo
[edit] VU

vulgar (coarse): maldelikata

vulgar (common): vulgara

Vulgate: Vulgato

vulpine: vulpa

vulture: vulturo 

W (name of letter): germana vo

wade: vadi

wading shoes: vadsxuoj

waffle: vaflo, ŝanceliĝadi

waffle iron: vaflofero

waffle, cream: kremvaflo

wag: sving(ig)i

wage(s): salajro

waist, waistline: talio

wait: atendi

waiter: kelnero

waitress: kelnerino

wake(n): vek(iĝ)i

Wales: Kimrujo

walk: piediri, marŝi

walk the dog: promenigi la hundon

walker (baby): paŝlernilo, irigilo

walking stick (bug): promenanta branĉo

walking stick (tool): promenstango

Walkman, portable cassette player: poŝ-kasedilo, poŝ-kasedludilo

wall: muro

wall airconditioner: murklimatizilo

wallpaper: tapeto

wallet: biletujo, monujo

walnut: juglando

wander: vagi

want: deziri, voli

war: milito

wardrobe: vestoŝranko

wares: varoj

warm: varma

warn: averti

warning: averto

warrior: militisto

wash: lavi

wash room: lavejo, necesejo

wash bowl: (lav)pelvo

washbasin: lavujo

washcloth: lavtuk(et)o

washer: (bolt) platringo

washing machine (clothes): lavmaŝino, lesivmaŝino

washing powder (BR): lesivpulvoro

washing up, do the: lavi la manĝilaron, purigi la manĝilaronwater: akvo

wasp: vespo

waste: malŝpari, malŝparo

watch: rigardi, brakhorloĝo

watch (a play, game, TV, etc.): spekti

water: akvo

water (a plant): akvumi

water, tap: kranakvo

water bottle: akvobotelo

water fountain: trinkfonto

water heater: akvovarmigilo

water park: akvoparko, akvoludejo?

water pipe: akvotubo

water pistol: akvopistoleto

water skiing: akvoskiado

water softener: akvomoligilo

watercolor: akvofarbo, -a

watercress: akvokreso

waterfront: havenkvartalo

watermelon: akvomelono

watering can: akvilo, verŝilo

watershoes: vadsxuoj

wave: ondo, sving(iĝ)i (la manon)

wave: agiti, svingeti, mansaluti

way: vojo, maniero

W.C.: necesejo
[edit] WE-

we: ni

weapon: armilo

wear: porti, esti vestita per

wear out: eluzi

weather: vetero

weather forecast: veterprognozo

weave: teksi

website, web site: retpaĝaro, paĝaro, TTTejo, retejo

wedding: edz(in)iĝo, geedziĝo

Wednesday: merkredo

wee: eta

wee wee: urino, -i, piso, -i

weed: trudherbo, fiherbo, herbaĉo

weed whacker: ŝnurtondilo

week: semajno

weekend: semajnfino

weep: plori

weigh: (have weight) pezi, (find weight of) pesi

weight: pezo

weighty: peza

welcome: bonvena, bonvenigi, bonvenon!

welcome (as a response to 'thank you'): tute ne, ne dankinde

well: bone, sana

well (interjection): nu

well done: brave!

Welsh: kimra

Welshman: kimro

west: okcidento, okcidenta

wet: malseka

what: kio, kiu, tio kio

what kind of: kia

what time is it: kioma horo (estas)?

whatchamacallit: umaĵo

whatever: (kio) ajn, (kiu) ajn

whatever, meh: ajne

wheat: tritiko

wheat flakes (cereal): tritikflokoj

wheel: rado

when: kiam

where: kie(n)

whether, if: ĉu

wheel (circle): rondiri

wheel (trundle): ruli

wheel (round: (turn round) turniĝi

wheel: rado

wheelbarrow: puŝĉareto

wheelchair: rulseĝo

wheeled (having wheels): radhava

wheelchair, motorized: motora rulseĝo

wheelie: baŭmigi (biciklon)

wheelwright: ĉarfaristo

whet: akrigi

whether: ĉu

which: kiu

whichever: kiu ajn

while, whilst: dum

whip (beat): bati

whip (with a whip): vipi

whip (stir, mix): kirli

whip (stirer, mixer): kirlilo, ŝaŭmigilo

whip: vipi

whippersnapper: malgravuleto

whisk, mixer: kirlilo, ŝaŭmigilo

whisper: flustri

whistle: fajfi, fajfilo

white: blanka

white beet, chard: folibeto

white trash: (ge)blankulaĉ(in)o(j)

who: kiu

whole: tuta, tuto

whole grain, whole meal: tutgrajna

wholesale: pogrande

whose: kies

why: kial
[edit] WI-

wide: larĝa

widow: vidvino

widower: vidvo

width: larĝo, larĝeco

wife: edzino

wiki: vikio

wild: sovaĝa

will: volo

willing: volanta

willingly: volante

win: gajni, venki

wind: vento

wind (spring): streĉi

winder, winder key: streĉilo

windmill: ventmuelejo, ventmuelilo

window: fenestro

window air conditioner: fenestra klimatizilo

window frame: fenestrokadro

wine: vino

wing: flugilo

wink: okulsigni

winter: vintro

wipe: viŝi

wire: drato, drati

wire nut: (drat)konektilo, dratingo

wisdom: saĝo

wise: saĝa

wiseguy: ŝercemulo

wish: deziri, -o

wit: sprito, spritulo

witch: sorĉist(in)o

witchcraft: sorĉ(art)o

witchdoctor: sorĉkuracisto

with: kun

with (by): per

without: sen

witness: atesti, atestanto

witty: sprita
[edit] WO-

wobble: ŝanceliĝa

woe!: ve!

woe (misfortune): malfeliĉo

woe (sorrow): malĝojo

woebegone: ve(aspekt)a

woeful: malĝoja

woman: virino

women's room, restroom, powder room: (virina) necesejo

wonder: (marvel) miri, (ask onself) scivoli

wonderful: mirinda

woo, court: amindumi

wood: (material) ligno

wood, woods: arbaro

wool: lano

woolen: lana

wooly: lan(ec)a

word: vorto

word: vortigi

word (information): avizo

word (promise): promeso

word for word: laŭvorta, -e

wording: vortigo

wordless: senvorta

wordy: multvorta

work: labori, laboro

work: verko

work (function): funkcii, -iĝi

world: mondo

worldwide: tutmonda, universala

world wide web, WWW: tut-tera-teksaĵo, TTT(tototo)

worm: vermo

worry: ĝeni, ĉagreni, -iĝi

worse: pli malbona

worship: adori, adoro

worst: plej malbona

worth: valoro, (be worth) valori

worthy: inda

wound: vundi, -o
[edit] WR-

wrap: (en)volvi

wrecking bar: rompbaskulo

wrench: boltilo

wrestle: lukti

wretchedly: mizere

write: skribi

write (original work): verki

writer: verkisto 

X (name of letter): ikso

X-ray: X-radio, iksoradio, radiografio, -i, radioskopio, -i, -a priesplorado

xenon: ksenono

xerographic: ksera, kserografia

xerographic copy: kserokopio

xerographography: ksero, kserografio

Xmas: Kristnasko

xylophone: ksilofono 

Y (name of letter): ipsilono

yacht: jakto

yak: poefago

yam: ignamo

yank: (abrupte,  -a) tiri, -o

Yank(ee): jankio, -a

yap: bojeti, -o

yapp: vasta ledbindaĵo, -e, -ita

yarn: rakonto

yarn: fadeno


year: jaro

yearn: sopiri

yellow: flava

yes: jes

yesterday: hieraŭ

yet (already): jam

yet (nevertheless): tamen

yet (still, of time): ankoraŭ; not yet: ankoraŭ ne

yet (until now): ĝis nun


yogurt: jogurto

yo-yo: jojo, jo-joo

yokel: kamparulo, grundulo

yolk (of an egg): flavaĵo

you: vi

young: juna

your: via; yours: la via

youth: junulo, junularo, juneco


Yugoslavia: Jugoslavujo

Yugoslav: jugoslava, jugoslavo 

zeal: fervoro, zeloteco?

zealot: zeloto, fervorulo?

zealous: fervora

zebra: zebro

zebu: zebuo

Zen: zen, -ismo

zehnana: (hinda) virinejo

zenith: zenito

zephyr: zefiro

zeppelin (airship): zepelino

zero: nulo

zest (gusto): gxuego, sxatego

zest (piquancy): pikanteco


zigzag: zigzago, -a, -i

zinc: zinko

'ziploc' bag: refermebla plastasako, refermebla (plasta) sandviĉsako

zipper, zip (BR): zipo

zircon: zirkono

zirconium: zirkonio

zither: citro

zloty: zloto


zodiac: zodiako

zodiacal: zodiaka

zone: zono

zombie: sorĉita kadavro

zoo: bestoĝarden, zoologia ĝardeno

zoological: zoologia

zoologist: zoologo

zoology: zoologio

zoophyte: zoofito

zouave, zuavo 
